a	un, uno, una[Article]
aardvark	cerdo hormiguero
aback	atra/s[Adverb]
aardvark	oso hormiguero[Noun]
aardvarks	cerdos hormigueros
aardvarks	osos hormigueros 
ab	prefijo que indica separacio/n
abacterial	abacteriano, sin bacterias
aback	hacia atras
abacus	a/baco
abaft	A popa (towards stern)/En popa (in stern)
abacuses	a/bacos
abases	"degrada; humilla[Verb]"
abalone	abulo/n
abaft	detra/s de[Adverb]
abandon	abandonar
abalones	abulones
abalones	orejas de mar[Noun]
abandoned	abandonado
abandoned	abandonada,abandonado, abandonados, abandonadas[Verb]
abandon	abandono[Noun]
abandons	abandona
abandoner	abandonador
abandoning	abandonando
abandoning	abandono
abandonment	abandono
abandonments	abandonos
abandonment	desamparo, deserci�n
abase	abatir
abandons	desampara
abased	degradado
abase	rebajar, degradar, humillar, abatir[Verb]
abasement	envilecimiento
abased	rebajado, degradado, humillado, abatido[Adjective]
abasements	humillaciones, degradaciones
abasement	rebajacio/n, degradacio/n, humillacio/n, abatimiento[Noun]
abaser	humillador
abashes	"avergu.enza; pone en situacio/n embarazosa[Verb]"
abash	avergonzar
abashed	avergonzado
abash	avergonzar, confundir, 
abating	" superando una marca; disminuyendo; situacio/n depresiva[Verb]"
abashment	Verg�enza.
abashing	vergonzante, vergonzoso
abashing	vergonzoso
abatement	Abolici�n, supresi�n
abate	amainar[viento, tormenta], abolir, descontar, calmarse[dolor, tormenta]bajar[inundaci�n][Verb]
abasing	humillante
abasing	humillante, degradante[Verb]
abashment	verguenza
abated	amainado, amplacado, mitigado
abated	aplacado, abolido, descontado, disminuido.NO AMPLACADO[Adjective]
abate	terminar, hacer cesar
abatements	Rebajas, descuentos, decaimientos,aboliciones
abatement	descuento, rebaja
abater	rebajador, mitigador[Noun]
abatements	s. descuento, rebaja, decaimiento
abates	sat�lites
clock	  ceas
aberrational	"aberrante; desviado[Adjective]"
abdicate	"renunciar a; abdicar[Verb]"
abbacy	Abad�a, convento, monasterio.
abatises	Barricads, parapetos, obst�culos
abatises	Barricadas
abatis	barricada con alambre de p�as, parapeto de troncos ca�dos
abatis	tala, abatida, barricada de alambre de p�as
abaxial	abacial
abaxial	abaxial, (Anatomi/a) aquella regio/n de un o/rgano alejada del eje[Adjective]
abattoir	degolladero, macelo, matadero.
abattoir	matadero (GB)[Noun]
abbas	ABBA= Padre, Dios. ABBAS, t�o de Mahoma.
abbacy	abadi/a
abbe	ABB�=Abate
abbas	aint
abbot	Abad
abberations	Aberraci�n
abbe	abate
abbeys	Abad�as, monasterios, conventos
abbeys	abadi/as
abbots	Abates. NO ABADES.
abbot	abad
abbreviates	Reducciones, res�menes, abreviaciones, compendios.
abbreviates	abrevia
abbreviate	acortar[Verb]
abbreviated	cortado
abc	abc
abc	abecedario
abbreviation	abreviacio/n
abbreviating	abreviando
abbreviations	abreviaciones
abbreviations	abreviaturas
abdication	"renuncia; abdicaci�n (de un monarca)[Noun]"
abdomen	(inf.)barriga, vientre
abducent	Abductor
abducens	m�sculo abductor
abducens	separador
abductor	Abductor
abducted	Separado de la l�nea media del cuerpo.
abducted	secuestrado, raptado
abducting	secuestrando, raptando
abduction	secuestro, rapto
abducting	separando, alejando de la l�nea media.
abductions	secuestros, raptos
abductors	Abductores
abductor	secuestrador
abeam	De trav�s
abducts	secuestra, rapta
abductors	secuestradores
abecedarian	abecedario
abeam	al trav/es
aberrancy	aberraci/on
abed	en cama, acostado
aberrance	equivocacio/n, extravi/o
aberrant	aberrante
aberrancy	error
aberrated	aberrado
aberrantly	aberrantemente
aberrant	ano/malo, irregular, errado
aberrate	aberrar
aberrate	desviar
aberration	aberracio/n
aberration	desviacio/n
afterbirth	"(fam) placenta; secundinas (Fam)[Noun]"
abjuring	"abjurando; abjuracio/n[Verb]"
abject	"miserable (poverty); rastrero (apology)[Adjective]"
abetted	Apoyado, instigado, incitado, colaborado
aberrations	aberraciones
abet	animar, colaborar
aberrations	desvi/os
abets	apoya, colabora
abets	encubre
abet	instigar, incitar, inducir
abetment	instigaci�n, apoyo
abhor	aborrecer, abominar (de)[Verb]
abetted	ayud/o
abeyant	en suspenso[Adjective]
abetter	instigador, co/mplice
abettor	instigador
abetting	instigando, incitando
abeyance	in~ en desuso[Adverb]
abiogenesis	abioge/nesis
abhorred	aborrecido[Adjective]
abhor	detestar
abhorring	aborreciente[Adjective]
abhorrently	en forma aborreciente, odiante[Adverb]
abhorred	odiado
abhorrence	odio
abhorrent	odioso
abhorrer	la persona que odia[Noun]
abilities	habilidades, capacidades
abided	moro/
abhors	odia
abide	quedar(se)
abide	respetar[Noun]
abidance	tolerancia, conformismo[Noun]
abider	morador
abides	mora
abiding	permanente, perdurable
abidingly	permanentemente[Adverb]
ability	habilidad, capacidad
ability	talento[Noun]
abiotic	abio/tico[Adjective]
abiogenetic	abiogen�tico[Adverb]
abiogenetical	abiogen�tico[Adjective]
abiogenetically	abiogen�ticamente[Adverb]
abiological	abiol�gico[Adjective]
abiologically	abol�gicamente[Adverb]
abiotically	abio/ticamente[Adverb]
abjuration	abjuraci�n
abject	abyecto
abjection	abyecci�n
abjections	abyecciones[Noun]
abjectness	abyeccio/n[Noun]
abjectly	abyectamente
abjures	abjura[Adverb]
abjured	abjurado
abjure	renunciar
abjurer	abjurar
abovementioned	"arriba citado,-a;susodicho,-a"
about	"de, sobre, acerca de; por[Preposition]"
abler	(comparativo) m�s capaz/h�bil
ablation	ablacio/n
ablate	extirpar
ablated	extirpado
ablating	extirpando
ablative	ablativo
ablation	extirpaci�n
ablaze	ardiendo
ablaze	ardiente[Adjective]
ablaut	quesontes
able	capaz
able	h�bil (skilled)[Adjective]
ablest	(comparativo) el m�s capaz/h�bil
abler	mas capaz[Adjective]
abnegate	(auto)sacrificarse[Verb]
ablution	abluci�n
abloom	en flor
ablest	m�s capaz[Adjective]
ablutionary	ablucionario[Adjective]
ablutions	abluciones
ably	ha/bilmente[Adverb]
ably	h�bilmente[Adverb]
aboard	a bordo
aboard	a bordo de[Preposition]
abnegate	abnegar?
abnegation	abnegacio/n
abnegation	abnegaci�n (autosacrificio)[Noun]
abnegates	abniega
abnegator	abnegador
abnormal	anormal
abnormalities	anormalidades
abnormality	anormalidad[Noun]
abnormality	anormalmente
abnormally	anormalmente
aboil	abolir
abodes	domicilios[Noun]
abode	sin domicilio fijo
abolish	abolir
abolishable	abolible
abolish	suprimir, abolir[Verb]
abolishes	abole
abolished	abolido
abolishable	suprimible
abolisher	abolicionista
abolishers	abolicionistas
abolishment	abolici/on
abolishing	aboliendo
abolition	abolicio/n
abolitionism	abolicionismo
abolition	supresi�n, abolici�n[Noun]
abolitionize	abolicionar[Verb]
abolitionists	abolicionistas
abominable	abominable
abomasal	del cuarto est�mago[Adjective]
abominably	abominablemente
abominate	abominar
abomination	abominacio/n
abominations	abominaciones
abominator	abominador
abominators	abominadores
aboral	aboral[Adjective]
aboriginal	aborigen
aborally	de manera aboral[Adverb]
aboriginally	aboriginalmente[Noun]
aborigine	aborigen,australino
aborigines	aborigenes[Noun]
abort	abortar
aborning	naciente[Adjective]
aborted	abortado
abort	aborto[Noun]
aborter	abortante
aborting	abortando
abortifacient	abortivo, que provoca aborto[Adjective]
abortionist	abortista
abortion	aborto
abortion	aborto (acci�n)[Noun]
abortionists	abortistas
abortive	abortivo
abortions	abortos
abortively	abortivamente
abortive	malogrado[Adjective]
aborts	abortos
abortiveness	calidad de  abortivo, infructuoso
abound	abundar
abounding	abundando
abounded	abundo/
abounds	abunda
aboveboard	"legi/timo;honesto"
aboveboard	leg�timo[Adjective]
aboveground	sobrenivel[Noun]
abrasives	"abrasivos; bruscos (manner)[Adjective]"
abracadabra	abracadabra
abradable	abrasible, que se desgasta con fricci�n[Adjective]
abrasion	abrasi/on
abradant	abrasivo[Adjective]
abrader	que raspa, desgasta o limpia por fricci�n[Adjective]
abrade	raer, raspar
abraded	ra�do, raspado
abrades	raspar[Verb]
abrading	raspando[Verb]
abrasions	abrasiones
abrasion	raspo/n, raspadura
abrasive	abrasivo
abrasively	abrasivamente
abrasive	brusco (manner)[Adjective]
abrasiveness	abrasividad
abrasively	bruscamente (manner)[Adverb]
abridged	"abreviado,-a; resumido,-a"
abreast	"de frente: ""to keep abreast of"" (fig): mantenerse al corriente de[Adverb]"
abrasives	abrasuvis
abreaction	abreaccio/n
abreact	liberar emociones verbalmente[Verb]
abridge	abreviar
abreast	de frente: to walk four~, caminar cuatro de frente[Adverb]
absolute	"absoluto,-a; completo,-a; puro,-a; incontrovertible; "
absence	"ausencia; falta;distraccio/n"
abrupt	"brusco,-a;a/spero;repentino,-a;su/bito;"
abrupt	"brusco (sudden); �spero (curt)[Adjective]"
abroad	"en el extranjero (to be); al extranjero (to go)[Adverb]"
abridgment	abreviaci�n
abridging	abreviando
abridgement	compendio
abridger	compendiador
abridges	compendia[Verb]
abroach	espitado[Adjective]
abrogate	abrogar
abroad	en el or la extranjaro
abrogation	abrogaci/on
abrogated	abrrogado[Adjective]
abrogates	abrroga[Verb]
abrogating	abrrogante[Adjective]
abruptly	"bruscamente; con aspereza; repentinamente"
abruptly	"repentinamente (leave); bruscamente (speak)[Adverb]"
abruption	ruptura, abrupcio/n[Noun]
abscond	"vi huir; fugarse"
abscond	escaparse[Verb]
abruptness	precipitaci�n, brusquedad
absconder	fugitivo, pr�fugo, desertor
absconded	oculto[Adjective]
absconding	fuga/ndose
absconds	ocultarse, esconderse[Verb]
absent	"ausente; "
absence	ausencia[Noun]
absences	ausencias
absentee	"ausente;absenista"
absent	ausente
absented	ausente
absented	ausentado[Verb]
absentminded	"distrai/do,-a; despistado,-a"
absenteeism	absentismo
absentee	ausente[Noun]
absentia	ausencia
absentees	ausentes
absenting	ausentando[Adverb]
absently	en ausencia[Adverb]
absinthe	absenta
absinth	ajenjo[Noun]
absents	ausentes
absentminded	distra�do[Adjective]
absentmindedly	distraido
absentmindedly	distraidamente[Adverb]
absentmindedness	olvidadizo
add	"agregar; (arith) sumar[Verb]"
accordingly	"por consiguiente; en consecuencia[Adverb]"
absolutely	"totalmente (totally); �por supuesto (que s�)! (certainly!)[Adverb]"
absolute	absoluto[Adjective]
accident	(automobile) choque[Noun]
abysmal	abismal[Noun]
absolutely	absolutamente
absolution	absoluci�n[Adverb]
absoluteness	absoluto
absolutes	absolutos[Noun]
absolutism	absolutismo
absolutist	absolutista[Adjective]
absolutistic	absolutista[Noun]
absolutization	absolutizaci�n[Noun]
absolutizes	absolutiza[Verb]
absolutize	absolutizar[Verb]
absolver	absolutor[Noun]
absolve	absolver
absolved	absuelto
absolving	absolver[Verb]
absolves	absuelve[Verb]
absorb	absorber[Verb]
absorbancy	absorbencia[Noun]
absorbable	absorbible[Noun]
absorbability	capacidad de absorber
absorbance	absorvencia
absorbs	absorbe[Verb]
absorbant	absorbente[Adjective]
absorbency	absorbencia[Noun]
absorbed	absorbido[Adjective]
absorbed	absorto[Adjective]
absorbent	absorbente[]
absorbing	absorbente[Adjective]
absorber	absorber[Verb]
absorbingly	absorbentemente[Verb]
absorptive	absorbente[Adjective]
absorbtions	absorciones[Noun]
absorption	absorcio/n
absorption	absorci�n[Noun]
abstain	abstener[Verb]
abstainer	abstemio[Noun]
abstain	absternerse
abstained	abstinente[Noun]
abstemious	abstemio, -a[]
abstaining	abstinente[Adjective]
abstention	abstencio/n
abstemiously	de forma abstemia[Adverb]
abstentions	abstenciones[Noun]
abstentious	abstencionista[Adjective]
abstinent	abstinente[Adjective]
abstinently	abstinentamente[Adverb]
abstract	abstracto
abstraction	abstracci�n[Noun]
abstractable	abstra�ble[Adjective]
abstract	resumen[Noun]
abstracted	abstracto[Noun]
abstractedly	abstrai/damente[Adverb]
abstracter	abstractor[Noun]
abstractedness	abstrasencia
abstracting	abstrayendo
abstractionism	abstraccionismo
abstractions	abstracciones[Noun]
abstractionists	abstraccionistas
abstractly	abstractamente[Adverb]
abstractness	abstracto[Adjective]
abstractor	abstractor
abstractors	abstractores
abstracts	abstractos[Adjective]
abstriction	abstriccio/n[Noun]
abstrict	cercenar[Verb]
abstruse	abstruso[Adjective]
absurd	absurdo
abstruseness	oscuridad
absurdism	absurdismo
absurdly	absurdamente[Adverb]
absurdity	absurdo[Noun]
absurdities	disparates (plural)[Noun]
absurdum	absurdo[Noun]
abundance	abundancia[Adjective]
abundant	abundante[Adjective]
abundantly	abundantemente[Adverb]
abusable	abusable
abuses	abusa
abuse	abuso
abuser	abusador
abused	maltratado
abusers	abusadores
abusing	abusando
abusive	abusivo
abusively	abusivamente
abusiveness	abusividad
abutilon	abutilon, (Bota/nica) ge/enero de las Malva/aceas
abut	terminar, confinar
abutments	estribos[Noun]
abutment	lindero[Noun]
abuts	lindar[Verb]
abyssal	abisal
abyss	abismo
abysmally	mali/simamente[Adverb]
abysses	abismos
acacia	acacia
academe	academia
academia	academia
academic	acade/mico
academical	acad�mico[Conjunction]
academically	academicamente
academies	academias
academician	acad�mico
academicianship	academicismo
academics	academicas
academicism	academicismo[Noun]
academy	academia
academism	academismo
acanthocephalan	acantoc�falo
acanthus	acanto[Noun]
acanthopterygian	acantopterigio
acanthuses	acantos[Noun]
acaulescent	acaule, sin tallo[Adjective]
accede	aceder
acceded	accedio/[Verb]
acceding	accediendo
accedes	consentir en[Verb]
accessed	accedido[Verb]
accelerando	accelerating[Verb]
accent	accento
accelerate	acelerar
accelerated	acelerado
accelerates	acelera
acceleratingly	aceleradamente[Adverb]
accelerating	acelerando
acceleration	aceleracio/n
accelerations	aceleraciones
accelerator	acelerador
accelerative	acelerativo
accelerators	aceleradores
accelerometer	aceler�metro
accelerometers	aceler�metros
accents	accentos
accented	acentuado
accent	el acento
accenting	acentuando[Verb]
accentless	sin acento[Adjective]
access	acceso
accentuation	acentuacio/n[Noun]
accentuated	acentuado
accentuate	acentuar
accentuating	acentuando[Verb]
accentuates	acentuar[Verb]
accept	aceptar
acceptability	aceptacio/n
acceptable	aceptable
acceptableness	aceptabilidad
acceptably	aceptable[Noun]
acceptance	aceptaci�n
acceptances	aceptacio/nes[Noun]
acceptation	aceptacio/n
accepted	aceptado
acceptedly	aceptadamente[Adverb]
accepting	aceptando[Verb]
accepter	aceptor[Adjective]
acceptor	aceptador[Noun]
acceptingly	con aceptaci�n[Adverb]
acceptors	aceptadores [Noun]
accepts	aceptar[Verb]
accessary	accesorio[Noun]
accessing	accediendo[Verb]
accessibility	accesibilidad[Noun]
accesses	accesos[Noun]
accessibleness	accesibilidad
accessible	accesible[Noun]
accessibility	acesible
accessibly	accesiblemente
accession	acceso[Noun]
accessorial	accesorio[Adjective]
accessions	accesos[Noun]
accessors	accesores
accessories	accesorios[Noun]
accessory	accesorio
accidence	accidente[Noun]
accidentalist	aacidentalista
accidental	accidental[Adjective]
accident	el accidente
accidentalism	accidentalismo
accidentally	accidentalmente[Adverb]
accidentalness	accidentalmente[Adverb]
accidentally	por accidente[Adverb]
accidently	accidentalmente
accidents	accidentes[Noun]
accommodation	accomadacio/n
acclaim	aclamar
acclaimed	aclamado
acclaim	aplaudir[Verb]
acclamation	aclamacio/n[Noun]
acclaims	aclamar[Verb]
acclaimed	aplaudido
acclimate	aclimar
acclimated	aclimatado
acclimation	aclimatacio/n
acclimates	aclimatar[Verb]
acclimating	aclimatando[Verb]
acclimatizable	aclimatable[Adjective]
acclimatization	aclimatacio/n[Noun]
acclimatize	aclimatizado[Noun]
acclimatized	aclimatizado[Noun]
acclimatize	climatizar[Verb]
acclimatizes	aclimatiza[Verb]
acclimatized	climatizado[Adjective]
acclimatizer	climatizador[Noun]
acclimatizers	climatizadores[Noun]
accolades	acoladas[Noun]
acclivity	cuesta, subida, pendiente[Noun]
accolade	espaldarazo
accommodate	acomodar
accommodated	acomodado
accommodatingly	acomodadamente[Adverb]
accommodated	alojado
accommodating	alojando[Verb]
accommodates	hospedar[Verb]
accommodator	acomodador[Noun]
accommodation	alojamiento[Noun]
accommodations	alojamientos[Noun]
accompanied	acompanado
accompanies	acompa�a
accompaniment	acompan~amiento
accompanist	acompanista
accompaniments	acompan~amientos
accompanists	acompanistas
accompany	acompan~ar[Verb]
accompanying	acompan~ando[Verb]
accompanyist	acompan~ante[Noun]
accompanyists	acompan~antes[Noun]
accord	acordar
accomplices	co/mplices[Noun]
accomplice	c�mplice[Noun]
accomplish	cumplido
accomplishing	cumpliendo
accomplishable	terminable[Noun]
accomplishes	termina  termino/
accomplished	terminado
accomplisher	terminador
accomplishers	terminadores
accomplishment	triunfo
accomplishments	triunfos
accorded	acordado
accord	acuerdo[Noun]
accordance	conforme[Noun]
accordances	concordancias
accordant	concordante
according	de acuerdo con
acuity	"n agudeza; visual _____ agudeza visual[Noun]"
acetylene	Acetileno[Noun]
accost	abordar[Verb]
accordion	acordeo/n[Noun]
accordionist	acordeonista[Noun]
accordions	acordeones[Noun]
accordionists	acordeonistas[Noun]
accords	acuerdos[Noun]
accosts	abordar[Verb]
accosted	acoso/[Verb]
acephalous	acefalo
acellular	acelular[Adjective]
accredit	acreditar
accountancy	contabilidad[Noun]
account	cuenta[Noun]
accountability	responsabilidad[Noun]
accountable	responsable[Adjective]
accountant	contable
accounted	contabilizo/, rindio/ cuentas[Verb]
accountants	contables
accountant	el contador
accounting	contabilidad[Noun]
accountings	contabilidades[Noun]
accounts	cuentas[Noun]
accouter	equipar[Verb]
accouterment	equipo[Noun]
accouterments	equipo[Noun]
accreditation	acreditacion
accustom	acostumbrar
accreditations	acreditaciones
acculturate	aculturar
accretion	aumento[Noun]
accredited	autorizado[Adjective]
accrue	aumentarse[Verb]
accretions	aumentos[Noun]
acculturated	aculturado
accumulable	acumulable[Noun]
accumulate	acumular
accumulated	acumulado
accumulate	acumular(se)[Verb]
accumulation	acumulaci�n[Verb]
accumulates	acumulado/a[Adjective]
accumulating	acumulando[Verb]
accumulations	acumulaciones[Verb]
accumulator	acumulador/ra
accumulative	acumulativo
accumulatively	acumulativamente[Adverb]
accumulators	acumuladores[Noun]
accuracy	acuracia
accuracies	precisio/nes[Noun]
accusation	acusacion
accurate	atinado, preciso[Noun]
accurate	exacto, preciso[Adjective]
accuracy	precisi�n[Noun]
accursed	maldito[Adjective]
accurately	precisi�n
accusations	acusaciones
accusative	acusativo/va
accuse	acusar
accusatory	acusatorio/a
accused	acusado/da
accuser	acusador/ra
accusing	acusando
accuses	acusas
accusor	acusador/ra
accustomed	acostumbrado
accustoming	acostumbrando
ace	as
acerbate	acerbar
acerbity	acerbidad, acritud[Noun]
acetaldehyde	acetaldehido[Noun]
acetamide	acetamida[Noun]
acetaminophen	acetaminofen[Noun]
acetaminophen	acetaminofe/n[Noun]
acetate	acetato
acetify	acetificar[Verb]
acetic	ac�tico
acetone	acetona
acetyl	acetilo[Noun]
acidulate	Acidular[Verb]
acidimeter	Medidor de acidez[Noun]
acid	a/cido
achromatic	acrom�tico[Adjective]
achievable	conseguible
ache	doler
ache	dolor[Noun]
ached	dolido
ached	doli�[Verb]
aches	duele
achieve	conseguir[Verb]
achievable	lograble
achieved	conseguido
achieve	lograr[Verb]
achieving	consiguiendo
achieves	logra[Verb]
achieved	logr�[Verb]
achievement	logro
achievements	logros
achiever	persona que logra sus metas
achievers	personas que logran sus metas
achingly	dolorosamente
achieving	que logra
aching	que duele
achromatically	acroma/ticamente[Adverb]
achromaticity	acromaticidad
achromatism	acromatismo
acidic	a/cido[Adjective]
acid	�cido
acidification	acidificaci�n
acidifier	que vuelve ac�do
acidify	volver ac�do
acidimeters	Medidores de acidez[Noun]
acidity	acidez
acidness	acidez[Noun]
acids	acidos
acidulant	acidulante
acidulation	Acidulaci�n[Noun]
acoustic	Ac�stica[Adjective]
acinus	a/cino[Noun]
acne	acn�
acknowledger	persona que reconoce
acknowledge	reconocer
acknowledgeable	reconocible
acknowledged	reconocido
acknowledgement	reconocimiento
acknowledgements	reconocimientos
acknowledging	reconociendo
acknowledgment	reconocimiento[Noun]
acolyte	aco/lito[Noun]
acolytes	aco/litos[Noun]
acorn	bellota[Noun]
acorns	bellotas[Noun]
acrobacy	Acrobacia[Noun]
acoustically	Ac�sticamente[Adverb]
acoustic	acu/stico[Adjective]
acquire	Adquirir[Verb]
acoustics	ac�stica[Noun]
acquaint	conocido[Noun]
acquaintance	conocido/da
acquaintances	conocidos/das
acquired	Adquirido[Verb]
acquirement	Adquisici�n[Noun]
acquisitions	Adquisiciones[Noun]
acquisition	adquisici�n[Noun]
acquires	vt   adquirir[Verb]
acre	acre[Noun]
acronym	Acr�nimo[Noun]
acrobatic	acrob�tico(a)[Adjective]
acrobat	acr�bata[Noun]
acrobatically	acrobaticamente[Adverb]
acrobatics	acrobacias[Noun]
acrobats	acr�batas[Noun]
acrophobic	Acrofobia[Noun]
acronymically	acron�micamente[Adverb]
acropetal	acropeta/lico[Adjective]
acronyms	acr�nimos[Noun]
acropetally	acropeta/licamente[Adverb]
acrylic	Acr�lico.
acropolis	Acr�polis[Noun]
acrostic	Acr�stico[Noun]
across	a trav�s[Adverb]
activated	Activado[Verb]
action	accio/n[Noun]
act	n- acto, vi (to behave) comportarse, to ___out (psych) expresar impulsos reprinudos en conducta sin inhibiciones
actions	acciones[Noun]
activate	activar[Verb]
activates	Activa[Verb]
activation	Activaci�n[Noun]
activations	Activaciones[Noun]
activator	Activador[Noun]
activators	Activadores[Noun]
activism	Activismo[Noun]
activeness	Cualidad de ser activo.[Noun]
actively	activamente[Adverb]
active	activo(a)[Adjective]
activity	Actividad[Noun]
activist	Activista[Adjective]
activists	Activistas[Adjective]
activities	las actividades
actresses	Actrices[Noun]
actors	los actores
actor	un actor
actress	una actriz
actualization	Actualizaci�n.[Noun]
actual	actual
actualizations	Actualizaciones[Noun]
actualizes	Actualiza[Verb]
actualize	Actualizar[Verb]
actualized	Actualizado[Verb]
acupuncture	Acupuntura.[Noun]
aculeate	aculeado[Adjective]
acumen	acumen[Noun]
acuminate	acuminado[Adjective]
acumination	acuminacio/n
acyclic	Ac�clico.[Adjective]
acute	Aguda,agudo.[Adjective]
acutely	Agudamente.[Adverb]
acuteness	Agudeza[Noun]
acyclically	Ac�clicamente[Adverb]
adapt	adaptar[Verb]
adapt	adaptar(se)
adaptability	adaptabilidad[Noun]
adaptivity	adaptabilidad
adaptable	adaptable[Adjective]
adaptation	adaptacio/n[Noun]
adaptational	adaptacional
adaptations	adaptaciones[Noun]
adapted	adaptado
adaptive	adaptativo
adaption	n - adaptacion (accent over  o)
adaptively	adaptativamente[Adverb]
adaxial	adaxial[Adjective]
adhesive	"adj - adhesivo; ______ tape - tela or cinta adhesiva"
addicted	(to become addicted) enviciarse volverse adicto
addenda	adendas
add	ma/s
addendum	adenda
addict	adicto
adductor	Abductor[Noun]
addiction	Adicci�n.[Noun]
addictions	Adicciones.[Noun]
address	Direcci�n[Noun]
addictive	adictivo
addition	adicio/n
addicts	adictos
addictive	que crea ha/bito
additive	adictivo, que crea habito (accent over  a  in habito[Adjective]
additive	aditivo )adj & noun)
additives	aditivos
addressee	Destinatario[Noun]
addressed	Dirigido[Verb]
address	domicilio[Noun]
addressees	Destinatarios[Noun]
addresses	Direcciones[Noun]
addresser	Remitente[Noun]
addressers	Remitentes[Noun]
adenoid	Adenoide
adenine	adenina
adenoidal	Adenoidal
adenoma	Adenoma
adenomatous	Adenomatoso
adept	Adepto[Noun]
adenosine	adenosina
adequate	adj - adecuado, suficiente
adhesion	n - adherencia
adhesions	n - adherencias
adjuvant	"adj - adyuvante; coadyuvante"
adjustment	"n -  ajuste -m; correccion -f  (accent over the  o); modificacion -f (accent over the o)"
adios	Adi�s
adiabatic	adiabatica (curva)
adipose	Adiposo
adiposity	Adiposidad
adjectives	Adjetivos.[Noun]
adjacent	Adyacente
adjective	el adjetivo
adjustable	adj - ajustable
adjust	vt - ajustar, modificar[Verb]
affect	"n  - (psych) afecto; vt afectar"
admission	"n - (to the hospital) adnision -f (accent over the   o); ingreso"
administrators	administradores
administration	n  -  administracion -f  (accent over  o)
admire	admirar
admitted	"vt (pret & pp) - (to be admitted) internarse, ingresarse; She was admitted yesterday - Fue internada ayar; You need to be admitted - ud. necesita ser internado."
admit	vt - (to the hospital) internar, ingressar [Verb]
adolescent	adj & n  -  adolescente
adobe	adobe
adolescence	n  - adolescencia
adoptive	adj  - adoptivo
adoption	adopcio/n[Noun]
adopt	vt  - adoptar[Verb]
adoptions	n  - adopciones -f (accent over second  o)
adsorbent	adj  - adsorbente
adrenalin	n  - adrenalina
aerobic	adj  - aerobico (accent over 1st  o)
adult	adj & n  - adulto -ta (mf)
advance	avance[Noun]
adverb	el adverbio
advantage	la ventaja
advertisement	el anuncio
advice	el consejo
aerosolized	adj  - en aerosol
aerosol	aerosol  -m[Noun]
aerobics	n pl - aerobicos (accent over 1st  o)
affair	asunto[Noun]
affairs	asuntos[Noun]
aficionada	aficionada (fan) -f
affectionate	carinoso[Adjective]
affection	n afecto, carino (enya over the  n)
affliction	mal. achaque[Noun]
affinity	n  - affinidad  -f
affinities	n pl  - affinidades  -f
aficionado	aficionada (fan) -m
afraid	to be afraid - tener miedo
bracket	"abrazadera; soporte"
agitate	"agitar; to become agitated agitarse"
age	"edad -f;   middle age - edad madura or mediana; old age - vejez -f[Noun]"
afternoon	la tarde
again	otra vez
aftertaste	sabor  -m[Noun]
agile	a/gil[Adjective]
agencies	agencias[Noun]
agency	agencia[Noun]
agent	agente -m[Noun]
aggravate	agravar[Verb]
aggression	agresio/n[Noun]
aggressions	agresio/nes[Noun]
aggressive	agresivo[Adjective]
aging	envejecimiento[Noun]
ante	"apuesta(poker); ante..."
aide	"asistente -mf; ayudante -mf; auxiliar -mf"
ago	"hace; atra/s (2 wks ago) hace dos semanas or dos semanas atra/s[Adjective]"
agitated	agitado[Adjective]
aid	"n -ayuda; auxilio; vt ayudar asistir"
aid	la curita
antagonize	"enemistarse con;"
ailment	"mal -m; achaque -m; padecimiento[Noun]"
aids	la SIDA[Noun]
airway	(breathing) vi/a ae/rea[Noun]
air	el aire
airport	el aeropuerto
aircraft	el avi�n[Noun]
airplanes	los aviones
airsickness	mareo 
am	2486
also	Tambien[Conjunction]
alarm	alarma[Noun]
alarmed	alarmado[Adjective]
alarming	alarmante[Adjective]
alarmingly	alarmantemente[Adverb]
alcohol	alcohol[Noun]
alcoholic	alcoholico[Noun]
alcoholism	alcoholismo[Noun]
algebra	algebra[Noun]
ale	cerveza
alloy	aleaci�n[Noun]
algebraically	algebraicamente[Adverb]
algorithm	algoritmo[Noun]
alibi	coartada[Noun]
allow	dejar
allow	permitir
all	todo
alloys	aleaci�nes[Noun]
almost	casi
almond	la almendra
allspice	malagueta[Noun]
alphabet	el alfabeto
alphabetic	english
already	ya
although	aunque
aluminum	el aluminio
altitude	la altitud
alto	long
always	siempre
amalgamate	amalgamar[Verb]
amalgamated	amalgamado[Adjective]
amass	amontonar[Verb]
amassed	amontado[Adjective]
amber	ambre[Noun]
amaze	asombrar[Verb]
amateur	novicio[Noun]
amazed	asombrado[Adjective]
amaze	pasmar[Verb]
amazement	asombro[Noun]
amazing	asombroso
amazement	pasmo[Noun]
ambassador	embajador[Noun]
amazing	pasmoso[Adjective]
amen	ame/n
ambulance	la ambulancia
amenities	amenidades
american	americano
amiable	amistable
amicably	amistablemente
animalcule	anima/lculo[Noun]
ancient	antiguo
amuse	divertir
amid	entre
amusing	divertido
animal	el animal
and	y
aniseed	an/is[Noun]
animate	animar, animarse[Verb]
animated	animado[Adjective]
animation	animacio/n[Noun]
anion	anio/n[Noun]
anisotropic	anisotropous[Adjective]
annihilate	aniquilar, anonadar[Verb]
ankle	el tobillo
ankles	los tobillos[Noun]
anniversaries	aniversarios
anniversary	aniversario
annotation	anotaci�n
annotate	notar
annotated	notado
antacid	antiacido
announce	anunciar[Verb]
announced	anunciado
announcers	anuciadors
announcer	anunciador
announcer	el locutor
annual	anual
annoy	burlarse
announcing	estar anunciando
annoys	se burla
ant	hormiga
ant	la hormiga
answer	la respuesta
antagonism	antagonismo
antagonistic	antagonico
antagonist	antagonista
antarctic	antartico
antechamber	"antecamara; antesala"
antecedent	antecedente
anteater	oso hormiguero
antecedents	antecedentes
anteroom	"antesala; antecamara"
antedate	"preceder; ser anterior a"
antenatal	"prenatal; antenatal"
antediluvian	antediluviano
antelope	antilope
antenna	antena
antennae	antena
anterior	anterior a
arteriole	"arteriola; pequena arteria[Noun]"
anthem	"motete(Eccl); himno nacional"
april	abril
anther	antera
anthologies	antologias
anthill	hormiguero
anthology	antologia
anthologist	antologista
anthologize	hacer una antologia de
anthracite	antracita
anthrop	antrop
anthropocentric	antropocentrico
anthropoid	antropoide
anthropophagous	antropofago
anthropological	antropologico
anthropology	antropologia
anthropologist	antropologo
anthropomorphic	antropomorfico
anthropomorphism	antropomorfismo
anthropophagy	antropofagia
apartment	apartamento[Noun]
applaud	aplaudir
apologize	disculparse
appetite	el apetito
appetizer	el aperitivo
applicable	aplicable
apple	apple
applause	el aplauso
apples	las manzanas
apples	manzanas
applesauce	pure de manzana
application	aplicacion
applicant	applicante
applicants	applicante
applicant	solicitante
appreciate	apreciar
appointment	la cita
appointments	las citas
apricot	el chabacano
around	alrededor
argue	arguir
arena	corrida[Noun]
aquarium	el acuarium
apron	el delantal
architect	el arquitecto
argument	el argumento
arm	el brazo
arms	los brazos
arrange	arreglar
art	arte
arrow	la flecha
arrive	llegar
artefact	artefacto
arterialization	arterializacion[Noun]
arterial	pertinente al transito[Adjective]
arterialize	arterializar[Verb]
arteries	las arterias[Noun]
artfully	"astutamente; ladinamente; artificiosamente; con artificio; con arte; diestramente"
artful	"diestro; habilidos; astuto; artificioso[Adjective]"
arterioles	"las arteriolas; las pequen~a arterias[Noun]"
arteriosclerosis	arteriolosclerosis[Noun]
boycott	"boicoteo; boicotear(verb)"
bat	"murci""e/""lago[Noun]"
backing	APOYO[Noun]
bacchic	BA/QUICO[Adjective]
at	a
arthritic	artr�tico
arthropod	artropodo
artificial	artificial
article	art�culo
artichoke	la alcachofa
asleep	dormido
ashtray	el cenicero
ask	preguntar
asterisk	el asterisco
aspirin	la aspirina
attitude	actitud[Noun]
attainableness	asequibilidad
ate	comi[Verb]
attainable	conseguilbe[Adjective]
athlete	el atleta
attend	asistir[Verb]
attempt	intento
attendance	asistencia[Noun]
attendant	asistente
attendants	asistentes
attentive	atento[Adjective]
attentively	atentamente[Pronoun]
attire	atraer[Verb]
attiring	atractivo[Adjective]
attired	atraido[Adjective]
attitudes	actitudes
august	agosto
b	b
author	el autor
auto	el auto[Noun]
avoid	eludir[Verb]
avoid	evitar[Verb]
avenue	la avenida
autumn	oton~o[Noun]
axe	la hacha
babble	balbucear
babbled	balbuceado
babble	balbucear[Verb]
babbles	balbucea
babbler	balbuceador
babblement	balbuceo
baboon	babui/no
babbling	balbuceando
babe	bebe
babes	beb�s
babe	nena
babies	bebe/s
babies	criaturas, bebes
babied	mimado (a)[Adjective]
babes	ni�os[Noun]
baccalaureate	bachillerato[Noun]
baby	bebe/
babushka	la babushka (sombrero ruso)[Noun]
babysitter	canguro
baby	criatura
babysit	cuidar
babyish	infantil[Adjective]
babyhood	ni�ez[Noun]
babyhood	nin~ez
babying	ninando
babysits	cuida a un bebe[Verb]
babysit	hacer de canguro[Verb]
babysitters	canguros
babysitter	nin~era
babysitting	cuidar nin~os[Verb]
babysitters	ni�era
baccarat	bacarr/a
baccalaureate	licenciatura
bacchanal	bacanal
bacchanalia	bacanal
bacchanal	jodienda
bacchanalian	bacan�lico (a)[Adjective]
backed	RESPALDADO[Adjective]
backdrops	TELONES[Noun]
bachelor	bachiller
bachelors	bachilleres
bachelor	soltero
bachelorhood	solteria
bacillar	bacilar
bachelors	solteros
bacilli	bacilos
bacillary	forma bacilar (de bacilo)
bacillus	bacilo
backbite	difamar[Verb]
backache	dolor de espalda
back	espalda (noun)
back	lomo (noun)
backaches	dolores de espalda
backbiter	el difamador[Noun]
backbone	espinazo
backbones	espinazo
backbones	espinazos
backbone	lomo
backdrop	telon
backer	RESPALDADOR[Noun]
backers	RESPALDADORES[Noun]
backhanded	ambiguo
backgrounds	antecedentes
backgammon	chaquete
backfire	petardeo
background	de fondo[Adjective]
background	fondo
backhand	reves
backhouse	letrina
backlogs	ATRASOS[Noun]
backless	SIN ESPALDA
backlash	barra invertida (\)
backlash	contragolpe
backlog	lista de cosas pendientes
backs	ESPALDAS[Noun]
backpack	bolso/n
backpack	mochila
backpacker	mochilero
backpacks	mochila
backrest	respaldo
bailable	achicable[Adjective]
backseat	asiento trasero
backward	atrasado[Adjective]
backups	backups, copia de seguridad[Noun]
backslash	barra invertida (\)
backside	espalda, lomo[Noun]
backstage	bastidores[Noun]
backslide	reincidir[Verb]
backslider	reincidente[Noun]
backspaced	retrocedido[Verb]
backspace	tecla de retroceso
backspaces	retrocesos[Noun]
backspacing	retrocediendo[Verb]
backup	copia de seguridad
backup	respaldo
backtrack	retrotraer
backwardness	atraso[Noun]
backwardly	retrospectivamente[Adverb]
bacteria	bacteria[Noun]
backwood	bosque[Noun]
backwash	estela[Noun]
backwards	hacia atra/s
backwater	remanso[Noun]
backwaters	remansos[Noun]
backwoods	bosque[Noun]
backwoodsman	bosqui/mano[Noun]
bacon	el tocino
backyard	patio de atras[Noun]
bacterial	bacteriano[Adjective]
bacterially	bacterianamente[Adverb]
bacterium	bacteria[Noun]
bactericidal	bactericida[Adjective]
bactericidally	bactericidamente[Adverb]
bactericide	bactericida[Adjective]
badminton	badminton[Noun]
badge	banda, cinta, emblema[Noun]
bad	malo
badges	condecoraciones[Noun]
badgered	molestado[Verb]
badger	tejo/n[Noun]
badgering	molestando[Verb]
badgers	tejones[Noun]
badly	malamente[Adverb]
bagatelle	bagatela[Noun]
bag	bolso
baffle	confundir[Verb]
badness	maldad[Noun]
baffled	confundido[Verb]
baffling	confundiendo[Verb]
bafflement	confusio/n[Noun]
baffler	deflector[Noun]
bafflers	deflectores[Noun]
bags	bolsas[Noun]
baggage	el equipaje[Noun]
bagpiper	gaitero (a)[Noun]
baggily	holgadamente[Adverb]
baggy	holgado[Adjective]
bagpipe	la gaita[Noun]
bagpipes	gaitas[Noun]
bail	pelota, balo/n[Noun]
barbarian	ba/rbaro[Adjective]
balalaika	balalaika[Noun]
bait	cebo[Noun]
bailee	depositario[Noun]
bailer	fiador[Noun]
baker	el panadero
bake	hornear
bakery	panaderia[Noun]
ballad	balada[Noun]
balance	balancear[Verb]
balalaika	pues eso
balcony	balcon[Noun]
balanced	equilibrado (a)[Adjective]
ball	bola[Noun]
ball	la pelota
ballade	balada[Noun]
ballerina	bailarina[Noun]
balladist	baladista[Adjective]
ballads	baladas[Noun]
ballast	lastre[Noun]
ballerinas	bailarinas[Noun]
ballet	ballet[Noun]
ballista	ballesta[Noun]
ballistic	bali/stico (a)[Adjective]
balsam	balsamo[Noun]
balls	bolas[Noun]
ballot	encuesta[Noun]
balloon	globo[Noun]
ballistics	la bali/stica[Noun]
balloons	globos[Noun]
balmy	suave[Adjective]
balsamic	balsa/mico (a)[Adjective]
bamboo	bamb�
balustrade	barandilla[Noun]
balustrades	barandillas
banal	banal[Adjective]
ban	prohibicion[Noun]
band	banda
banana	platano
bananas	platano[Noun]
bank	banco
bandit	bandido[Noun]
bandage	la venda
bandits	bandito
bandoleer	bandolero[Noun]
bankrupt	bancarrota, quiebra economica[Noun]
bank	el banco
banker	el banquero
banquet	banquete[Noun]
bar	barra[Noun]
barbarians	b/arbaros[Adjective]
basketball	baloncesto[Noun]
barbaric	barbario[Adjective]
barbarities	barbaridades[Adjective]
barbarism	barbarismo[Adjective]
barbecue	barbacoa[Noun]
barbarization	barbarizacio/n[Adjective]
barbarize	barbarizar[Verb]
barber	el barbero
barn	el troje
basket	la cesta
baskets	las cestas
boring	aborrido[Adjective]
bored	aburrido
bitter	amargo
before	antes
beacon	atalaya[Noun]
be	be
bathroom	el bano[Noun]
beachboy	chico de la playa[Noun]
beach	la playa
be	ser[Verb]
beer	cerveza
beer	la cerveza
bedspread	la colcha
beds	las camas
bead	perla, cuenta[Noun]
because	porque
beaming	radiante, brillante[Adjective]
beaker	vaso de precipitados[Noun]
beamy	radiante, brillante[Adjective]
below	bajo[Adjective]
beige	beige
beginning	el principio
begin	empezar
begin	empezar[Noun]
believe	creer
bell	la campana
bells	las campanas
biff	biffar[Verb]
best	el mejor
benchmark	evaluaci�n comparativa[Noun]
benchmarking	evaluaci�n comparativa (hacer una)[Verb]
benchmarks	evaluaciones comparativas
between	entre
better	mejor
bien	good[Adjective]
bicycle	la bicicleta
biochemical	bioquimico[Noun]
big	grande
bite	bocado, picada[Noun]
birthday	cumplean~os[Noun]
birth	el nacimiento
bit	el bit (computadora)
bitch	perra[Noun]
bitches	putas, putos[Noun]
bits	los bits (computadora)
bite	morder
biting	mordaz, penetrante[Adjective]
bitterness	amargura, rencor[Noun]
blueprint	anteproyecto[Noun]
blue	azul
block	bloque
blind	ciego
blanket	la manta
blackboard	la pizarra
black	negro
bladders	las vejigas[Noun]
bladder	vejiga[Noun]
bleed	sangrar
blizzard	la ventisca
blinds	persianas
blocked	bloqueado
blouse	la blusa
blood	la sangre
blond	rubio
blonde	rubio
boot	bota[Noun]
boat	el barco
body	el cuerpo
bookcase	el estante de libros[Noun]
bone	el hueso
boil	hervir
book	el libro
bones	los huesos
bookstore	la tienda de libros[Noun]
books	los libros
boots	botas[Noun]
both	ambos/as[Adjective]
boss	el jefe
boy	chico, chamaco, nino
boy	el muchacho
bottle	la botella
bother	molestar
box	la caja
bottles	las botellas
boxes	las cajas
brace	abrazadera
boyfriend	amigo
boycotted	boicoteado
boys	los muchachos
boyhood	muchachez,juventud
boyfriend	novio
boyish	muchachil, juvenil
bra	sosten
bra	sujetador[Noun]
bracelet	el brazalete
bracken	helecho
bracelet	pulsera
brag	"bravata; jactarse & fanfarronear(v)"
brae	"ladera de monte; pendiente"
brad	"puntilla; clavito"
brackish	"salobre; semisalado"
brahma	"brahaman; bracman"
braggart	"fanfarron; jactancioso"
bragging	fanfarronadas
brainless	"estupido; insensato"
brainchild	"parto del ingenio; invento"
braid	"trenza; galon(mil)"
brain	cerebro
caballero	"gent;emen"
brains	"inteligencia; cabeza"
brainpower	fuerza intelectual
brainwash	"lavar el cerebro a; "
brainstorm	idea genial
brainteaser	rompecabezas
brainy	"muy inteligente; talentudo"
brainwashing	lavado de cerebro
cab	POLICIA[Noun]
broad	ancho[Adjective]
braise	brasear
branchia	branquia[Noun]
brake	freno
branch	la rama
brakeless	sin freno[Adjective]
branches	ramas[Noun]
brandy	brandy[Noun]
branchial	branquial[Noun]
branchiate	branquiado[Adjective]
brand	marca[Noun]
branchless	sin ramas
breakfast	el desayuno
bread	el pan
bravery	el valor
brass	metal[Noun]
brasserie	panaderia[Noun]
bratwurst	salchicha[Noun]
break	romper
brick	el ladrillo
breeze	la brisa
breathe	respirar
bridge	el puente
bring	traer
broadband	ancho de banda
bus	autobus
brush	el cepillo
brother	el hermano
broom	la escoba
broken	roto
brunette	moreno
brown	pardo
bucket	el cubo
building	el edificio
bug	error[Adjective]
bull	el toro
burn	la quemadura
burn	quemar
c	c
buy	comprar
bush	el arbusto
bus	la guagua (Canary Islands)[Noun]
business	el negocio
butter	la mantequilla
butter	mantequilla
busy	ocupado
but	pero
butterfish	mariposa
buyer	comprador
byte	el byte[Noun]
bytes	los bytes[Noun]
c'mon	vamos
cabala	ca/bala
cabal	concilia/bulo[Noun]
cab	taxi, radiotaxi
cabalism	cabalismo[Noun]
cabalist	cabalista[Noun]
cabalistic	cbali/stico(a)
caboose	"fog�n; cocina[Noun]"
cabinet	armario
cabbala	ca/bala[Noun]
cabana	caban�
caballero	knight[Noun]
cabanas	caban~as
cabaret	cabaret
cabbage	col
cabbages	coles
cabbage	la col
cabbaged	repollado[Adjective]
cabbaging	repollando[Verb]
cabin	cabina
cabin	litera
cabbies	los taxistas
cabdriver	taxista
cabinets	armarios
cabinetmaker	ebanista
cabinet	gabinete
cabinetmakers	ebanistas
cabinetmakers	ebanister/ia
cabinetmaking	ebanister/ia
cabins	cabinas
cabinetwork	ebanisteri/a[Noun]
cabinets	gabinetes
cable	cable
cabled	cableado, telegrafiado[Noun]
cabling	cableado, cableando, telegrafiando
cablegram	cablegrama[Noun]
cableway	cablecarril[Noun]
cablegrams	cablegramas[Noun]
cables	cables
cablet	estacha[Noun]
caboodle	mont�n[Noun]
cabman	taxista[Noun]
calamite	Calamites[Noun]
calamint	ajedrea[Noun]
cabotage	cabotaje[Noun]
cabriole	cabriola[Noun]
cabriolet	cabriolet[Noun]
cacao	cacao
cabstand	parada de taxis[Noun]
cabs	taxis
cacciatore	caciatore
cachalot	cachalote[Noun]
cacciatore	hunter
cacophonous	cacofo/nico[Adjective]
cacophonously	cacofo/nicamente[Adverb]
cacophony	cacofoni/a[Noun]
cacti	cactus
cactuses	cactos[Noun]
cactus	el cacto
cacuminal	cacuminal[Adjective]
cadaver	cada/ver
cadastral	catastral[Noun]
cadastre	catastro[Noun]
cadaveric	cadav�rico
cadaverine	cadaverina[Noun]
cadence	cadencia ( musical)
caddy	estuche[Noun]
cadences	cadencias[Noun]
cadency	cadencia[Noun]
cadenza	cadencia[Noun]
cadet	cadete
cadmium	cadmio
cadge	sablear, gorronear[Verb]
caducean	caduco
cadre	cuadro[Noun]
caduceus	caduceo[Noun]
caducity	caducidad
caducous	caduco[Adjective]
cafe	cafe/
cafes	cafe/s
cafeteria	cafeteri/a
caffeine	cafei/na
cafeterias	cafeteri/as
caftan	cafta/n[Noun]
caiman	caima/n
cahier	cuaderno[Noun]
caged	enjaulado
cage	jaula
cage	la jaula
cages	jaulas
calabash	calabaza[Noun]
cake	el pastel
cakes	pasteles
cakes	tortas
calaboose	calabozo[Noun]
calamine	calamina[Noun]
capital	Capitolio ( as in building) 
capella	a capella
candied	acaramelado
calamus	acoro, pluma[Noun]
calamities	calamidades
calamity	calamidad
calamitous	calamitoso
calamitously	calamitosamente[Adverb]
camphor	alca/nfor
calla	aro palustre
calcic	ca/lcico
calash	calesa[Noun]
calculation	ca/lculo
calcimine	encalar[Verb]
calculations	ca/lculos
calculus	ca/lculo
calculi	ca/lculos[Noun]
caleche	calesa[Noun]
calendar	calendario, almanaque
calendars	calendarios, almanaques
calendar	el calendario
calends	calendas[Noun]
calenture	calentura[Noun]
calendula	cal�ndula, maravilla[Noun]
caliber	calibre
calf	chivo
calfs	pantorrillas[Noun]
calibrate	calibrar
calibers	calibre[Noun]
calibrated	calibrado
calibrates	calibra[Verb]
calibration	calibracio/n[Noun]
calibrating	calibrando, calibrante[Verb]
calibrations	calibraciones[Noun]
calibrator	calibrador[Adjective]
calibrators	calibradores[Adjective]
calibre	calibre[Noun]
caliper	calibre, pie de rey[Noun]
californium	californio[Noun]
caliginous	caliginoso[Adjective]
calipers	calibres, pies de rey[Noun]
caliph	califa[Noun]
caliphal	califal[Adjective]
caliphate	califato[Noun]
caliphs	califas[Noun]
calisthenic	calist�nico[Adjective]
calisthenics	calistenia[Noun]
call	llamar
calligrapher	cali/grafo[Noun]
called	llamo/
calligraphers	cali/grafos[Noun]
calligraphist	cali/grafo[Noun]
calligraphic	caligra/fico[Noun]
calligraphically	caligra/ficamente[Adverb]
calliper	calibre, pie de rey[Noun]
calligraphy	caligrafi/a
calling	llamado ( as in calling in life)
callosity	callosidad[Noun]
callus	callo
callous	calloso[Adjective]
calls	llamadas
calluses	callos
calm	calmar ( verb)
calmative	calmante 
calmed	calmado
calmly	calmadamente
calming	calmante
calms	calma
calmness	tranquilidad
caloric	calori/fico
calorie	calori/a
calories	calori/as
calumniate	calumniar
calumniation	calumnia
camaraderie	camaraderi/a
camera	camara
camel	camello
came	vino
camelia	camelia
camels	camellos
cameraman	camaro/grafo
cameras	camaras
cameramen	camaro/grafos
camp	campo
campaign	campan~a
campaigns	campan~as
campesinos	country folk
campfire	fogata
cancer	ca/ncer
camps	campamentos
canal	canal
can opener	el abrelatas
can	la lata
can	lata
campus	recinto
campuses	recintos
can't	no puede
canals	canales
canaries	canarios
canary	canario
canasta	canasta ( basket)
cancan	cancan ( the dance)
cancel	cancelar
cancelation	cancelacio/n
cancelations	cancelaciones
cancellations	cancelaciones
canceled	cancelo/
cancelling	cancelando
cancelled	cancelo/
candid	ca/ndido
cancerous	canceroso
candelabra	candelabro
candidate	candidato
candidates	candidatos
cane	basto/n ( as in walking stick)
candleholder	candelabro
candies	caramelos
candle	la vela
candle	vela
candy	caramelo
candy	el dulce
canes	bastones
cannibal	cani/bal
canned	enlatado
cannibalism	canibalismo
cannibals	canibales
cannon	can~on
canoe	canoa
canoes	canoas
canon	canonizar ( to canonize )
cantata	cantata
cans	las latas
cantaloupe	melo/n
cantina	cantina
capability	capacidad
capabilities	capacidades
cap	el gorro
capacity	capacidad
capacitate	capacitar
capable	capaz
capacities	capacidades
cape	capa
capitalism	Capitalismo
capital	la capital
caress	acariciar
car	automo/vil, carro
capsule	ca/psula
capitalist	capitalista 
capitalists	capitalistas
capitol	capitolio
capitols	capitolios
capriccio	capricho
capricious	caprichoso
capriciously	caprichosamente
capsules	ca/psulas
capuchin	cachupi/n
captain	capita/n
captivate	cautivar
captive	cautivo
captives	cautivos
caravan	caravana
car	el coche
car window	la ventanilla
caravans	caravanas
caravel	caravela
carbohydrate	carbohi/drato
carbon	carbo/n
carbohydrates	carbohi/dratos
carcinogen	carcino/geno
carcinogenic	carcinoge/nico
carcinoma	carcinoma
cardiac	cardi/aco
card	tarjeta
cardiogram	cardiograma
cardiograms	cardiogramas
cardiovascular	cardiovascular
care	cuidado
careful	cuidadoso
career	profesio/n
careers	profesiones
carefree	sin cuidado
carefully	cuidadosamente
carefulness	cuidado
carelessly	sin cuidado
chocolaty	achocolata/do (a)[Adjective]
certifies	acredita
certification	acreditadacio/n
carpet	alfombra
carol	cantata
caresses	caricias
cargo	carga
cargoes	cargas
cargos	cargas
caribe	cari/be
caricature	caricatura
caricaturist	caricurista
carnival	carnaval
carnivals	carnavales
carnivore	carni/voro
carousel	carusel
carpenter	carpintero
carpentry	carpinteri/a
carpenters	carpinteros
carpenter	el carpintero
census	apadronamiento, censo
celery	apio
cast	arrojar, lanzar, echar (dados), asignar (papeles en el teatro)fundir, colar
cars	automo/viles, carros
carry	cargar
carpet	la alfombra
carrot	la zanahoria
carrying	cargando
carryall	cargatodo
carry	llevar
cashier	cajero
cart	carretilla
cars	los coches
carte	carta ( as in a la carte )
carts	carretillas
cartel	cartel
cartilage	carti/lago
cartographer	carto/grafo
cartographers	carto/grafos
cartographic	cartogra/fico
cartomancy	carto/mancia
cartography	cartografi/a
cartoon	mun~equitos
casa	casa (house)
carve	tallar
carved	tallado
casaba	casaba ( vegetable )
casa	house[Conjunction]
cascade	cascada
cascades	cascadas
cash	efectivo
cashiers	cajeros
cashier	el cajero
casino	casino
casinos	casinos
cavities	caries
castanet	castan~uela
castanets	castan~uelas
castigate	castigar
castigated	castigado
castigates	castiga
castigator	castigador
castigation	castigo
castigators	castigadores
castle	castillo
castles	castillos
castle	el castillo
castrate	castrar
castrated	castrado
cataclysm	cataclismo
cat	el gato
cat	gato
casual	informal
catalog	cata/logo
catacomb	catacumba
catalogs	cata/logos
cataloged	catalogado
catalogues	cata/logos
catastrophe	cata/strofe
catastrophes	cata/strofes
categorize	catalogar
catastrophic	catastro/fico
catatonic	catato/nico
catechism	catecismo
catch	coger
categoric	catego/rico
categorically	catego/ricamente
categories	categori/as
caudal	caudal
cats	los gatos
caudillo	caudillo
cause	causa
cauliflower	coli/flor
cauliflowers	coliflores
cauliflower	la coliflor
caution	cautela
caviar	cavia/r
cave	cueva
caves	cuevas
cave	la cueva
cavity	carie ( dentist)
cay	cayo
celebrities	ce/lebres
cedar	cedro
cease	cesar
ceases	cesa
ceased	ceso/
ceasefire	cese al fuego
cedarwood	cedro
cede	ceder
cedilla	cedilla
celebrate	celebrar
ceiling	el techo
celebrant	festejante, celebrador
ceiling	techo
celebrants	festejantes,celebradores
celebrates	festeja, celebra
celebrate	festejar,celebrar
celebrated	festejo/, celebro/
celebration	festividad
celebrations	festividades
celebrity	ce/lebre
cellar	bodega
cell	ce/dula
celestial	celestial
celery	el apio
celibacy	celibato
cellars	bodegas
cells	ce/dulas
cellular	celular ( anglicism)
cement	cemento
cemeteries	cementerios
cemented	encementado
cemetery	cementerio
censor	censurador
cemetery	el cementerio
censored	censurado
censorship	censura
censors	censuradores
censuses	apadronamientos, censos
centric	ce/ntrico
cent	centavo
centavo	centavo
cent	el centavo
centenarian	centenario
centesimo	cente/simo
center	centro
centerpiece	centro de mesa
center	el centro
centerpieces	centros de mesa
centers	centros
centigrade	centi/grado
centigram	centi/gramo
centigrams	centi/gramos
centime	centimo
centimo	centimo
cephalic	cefa/lico
cents	centavos
centurion	centurio/n
centuries	siglos
century	el siglo
century	siglo
ceramic	cera/mica
ceramics	cera/micas
ceramist	cera/mico
cereal	cereal
cereals	cereales
cerebellum	cerebellum
ceremonial	ceremonial
certainty	certidumbre[Noun]
certain	cierto
certainly	ciertamente
certifiable	certificable
certificate	certificado (noun)
certificated	certificado
certificates	certificados
certified	acreditado
certify	acreditar
chess	ajedrez
cheerfully	alegremente
charms	amuletos ( noun)
chancy	arriesgado[Adjective]
chance	azar
chance	oportunidad[Noun]
chalkboard	pizarra
chairman	presidente[Noun]
chair	silla
chairmanship	presidencia[Noun]
chalk	yeso[Noun]
chalks	tizas
chalky	yesoso[Adjective]
chapeau	cabeza ( head )
change	cambiar
chandelier	candelabro[Noun]
chandelier	chandelie/r
chandeliers	chandelie/res
changing	cambiando
change	cambio
changed	cambio/
changes	cambios
channel	canal
chanson	canci/on ( song )
chanteuse	cantante ( singer m or f )
chanteuses	cantantes
chaos	caos
chaotic	cao/tico
chaos	chaos
chaotically	cao/ticamente
chapter	capi/tulo
chaperon	chapero/n
chapel	iglesia 
chapels	iglesias
chapelles	sombreros ( hats )
chaperone	chapero/n
chapters	capi/tulos
character	cara/cter
characteristic	caracteri/stica
characters	cara/cteres
characteristics	caracteri/sticas
charcoal	carbo/n
charade	charada
charades	charadas
chargeable	cargable
charge	cargar ( batteries)
charcuterie	cuchilleri/a ( knives )
charged	cargado
charity	caridad
charisma	carisma
charismatic	carisma/tico
charitable	caritativo
charlatan	charlata/n
charlatans	charlatanes
charm	echizar
charm	encantar (verb) amuleto ( noun)
charmed	encantado
charming	encantador
cheap	barato
chastity	castidad
chastise	castigar
chaste	casto
chase	cazar
chase	perseguir
chaser	perseguidor
chased	persiguio/ 
chastised	castigo/
chastisement	castigo
chastisements	castigos
chat	charlar
chats	charlas
chatted	charlo/
chauffeur	chofe/r
chauvinism	machismo
chauvinist	machista
chauvinistic	machista
chauvinists	machistas
check	cheque
cheaper	ma/s barato
cheapie	tacan~o
cheapskate	tacan~o
cheapskates	tacan~os
checkbook	chequera
checkbooks	chequeras
checkers	damas ( game)
checkmate	jaquemate ( chess)
cheek	la mejilla
cheek	mejilla
cheeks	mejillas
cheekbone	po/mulo
cheekbones	po/mulos
cheerfulness	alegri/a
cheerily	alegremente
chemise	camisa ( men's shirt)
cheers	chi/n, chi/n,  ( in a brindis)
chef	cocinero
cheese	el queso
cheeseburger	hamburquesa de queso
cheese	queso
cheeseburgers	hamburguesas de queso
chefs	cocineros
chemical	qui/mico
chemises	camisas
cherries	cerezas
cherish	querer
chemist	qui/mico
chemistry	qui/mica
chemists	qui/micos
cherished	querido
cherry	cereza
cherry	la cereza
cherub	querubi/n
cherubs	querubines
chin	barba
childish	bo/bo (a)[Adjective]
chickadee	bohi/o
chestnut	castan~a
chess	el ajedrez
chest	el pecho
chest	pecho
chessman	pieza de ajedrez
chessboard	tabla de ajedrez
chessboards	tablas de ajedrez
chestnuts	castan~as
chic	chic
chew	mascar
chew	masticar
chewable	masticable
chewing	masticando
chewed	mastico/
chick	pollito
chickadees	bohi/os
chicle	chicle ( gum)
chickenhearted	coba/rde
chicken	el pollo
chicken	pollo
chickpea	garbanzo
chickens	pollos
chickpeas	garbanzos
chieftain	je/fe
chiefly	principalmente[Adverb]
chide	regan~ar
chieftaincy	jefatu/ra
child	nin~a (f)
child	nin~o
childhood	nin~ez
chili	chili
children	nin~os
childless	sin descende/ncia
chimney	chimenea
chill	escalofri/o (med.)
chills	escalofri/os (ned)
chimneys	chimeneas
chimney	la chimenea
chimp	chimpance/
chimpanzee	chimpanc/e
chimpanzees	chimpance/s
chimps	chimpance/s
chocolate	chocolate
chloral	clora/l
chin	la barbilla
chiropractor	me/dico quiropra/ctico 
chiropractic	quiropra/ctica
chipmunk	top/o
chinaware	vajilla
chiropractors	me/dicos quiropra/cticos
chlorine	clo/ro
chlorate	clora/to
chloride	cloru/ro
chlorides	cloru/ros
chloroform	clorofo/rmo
chlorophyll	cloro/filo
chloroplast	cloropla/sto
chocolates	chocolates
chocolate	el chocolate
clamp	apretar, embridar, sujetar[Verb]
chuckhole	ba/che (mex.)
christened	bautiza/do (a)[Adjective]
chorizo	chorizo ( spanish sausage )
cholera	co/lera ( disease)
choir	coro
choice	escogi/do (a)[Adjective]
choicest	mas escogi/do (a)
choirboy	corista
choirs	coros
choke	estrangular
choleric	cole/rico
cholesterol	colestero/l
choline	coli/na
cholinergic	coline/rgico (a)[Adjective]
cholinesterase	colinestera/sa
choose	escoger
choose	escojer ( to choose)
chore	la tarea
chopstick	pali/llo chi/no
chopsticks	pali/llos chi/nos
chose	escojer
chortle	reir(se)[Verb]
christening	bauti/zo
chromate	crom/ado (a)
christmas	la Navidad
chrome	cro/mo
chromatic	croma/tico (a)[Adjective]
chromatography	cromatografi/a
chrysanthemum	crisa/ntemo
chronic	cro/nico (a)[Adjective]
chromium	cromo
chromosomal	cromosoma/l[Adjective]
chromosome	cromoso/ma
chromosomes	cromoso/mas
chromosomic	cromoso/mico (a)[Adjective]
chronicle	cro/nica
chronically	cronicame/nte[Adverb]
chronicity	cronicida/d
chronicles	cro/nicas
chronologer	crono/logo
chronologic	cronolo/gico (a)[Adjective]
chronological	cronolo/gico (a)[Adjective]
chronologist	crono/logo
chronologically	cronologicame/nte[Adverb]
chronologists	crono/logos
chronometer	crono/metro
chronology	cronologi/a
chronologize	cronologiza/r[Verb]
chronometric	cronome/trico (a)[Adjective]
chrysanthemums	crisa/ntemos
cinder	ceniza (ash)
ciliary	ciliario (a)[Adjective]
cigar	el cigarro
chunk	el tro/zo
cicadas	la cigarra
church	la iglesia
chunks	troci/tos
churches	las igle/sias
chutzpah	personalidad
churn	revolver(se)[Verb]
churchless	sin iglesia[Adjective]
churned	revuelto (a)[Adjective]
cider	la sidra
cigarette	el cigarrillo
cigarette	el cigarro (mex)
cigar	el puro (mex)
cilia	la cilia
cigarettes	los cigarros (mex)
cigars	los puros
cinders	cenizas
cinematography	cinematografi/a
circular	circular[Adjective]
circle	el ci/rculo
cinnamon	la canela
cipher	la cifra
circuit	el circuito
circuits	los circuitos
circulated	circulado (a)[Adjective]
circulate	circular[Verb]
circulates	circula[Verb]
circulatory	circulatorio (med)
circulation	la circulacion
circus	el circo
circumcision	la circuncision
circumference	la circunferencia
clam	la almeja
city	la ciudad
cliff	el acantilado
clerk	el dependiente
class	la clase
clean	limpiar
clean	limpio
climate	el clima
climb	subir
open	             
dick	 declaracion, polla (vulg)[Noun]
daffy	"chiflado; loco[Adjective]"
daedal	"intrincado; completo[Adjective]"
covenant	alianza[Noun]
contend	altercar[Verb]
comrade	amigo[Noun]
cockpit	cabina [de un piloto][Noun]
cockatoo	cacatua[Noun]
close	cerrar
clock	el reloj
clockwise	en el sentido de las agujas del reloj[Adverb]
clockwork	mecanico[Adjective]
clockwise	q
closed	cerrado
closet	el armario
closet	el closet[Noun]
clown	el payaso
cloud	la nube
clothes	la ropa[Noun]
cloth	la tela
clothing	la ropa
clouds	las nubes
cloudy	nublado
cock	gallo[Noun]
cock	pija, pene[Noun]
comedian	co/mico[Noun]
cocktail	coctail[Noun]
cockroach	la cucaracha
combustibles	combustibles[Noun]
coconut	el coco
collar	el collar (for dog)[Noun]
coffeepot	la cafetera
college	el colegio
collar	el cuello
color	el color
comb	el peine
colors	los colores
combustion	combustio/n[Noun]
comeback	regresar[Verb]
come	venir
comedienne	co/mica[Noun]
comedians	co/micos[Noun]
comediennes	co/micas[Noun]
comical	co/mico[Adjective]
comfortable	co/modo[Adjective]
comer	comest
comedy	la comedia
comet	cometa[Noun]
comer	t.v.
comets	cometas[Noun]
comfort	comodidad[Noun]
comic	comer
comforter	confortador[Noun]
comforting	confortante[Adjective]
commandant	comandante[Noun]
comma	la coma
command	mando[Noun]
commas	comas[Noun]
commands	o/rdenes[Noun]
computer	computadora
commemorate	conmemorar[Verb]
complain	quejarse
commendable	recomendable[Adjective]
computers	computadoras[Noun]
contemporary	coeta/neo[Adjective]
contemporary	contempora/neo[Adjective]
concert	el concierto
contemplating	meditando[Verb]
contact	ponerse en contacto
consumptive	t�sico[Noun]
contemplate	proyectar[Verb]
contemplates	proyecta[Verb]
contemplation	meditacio/n[Noun]
contemplations	meditaciones[Noun]
contempt	desde/n[Noun]
contemptuous	desden~oso[Adjective]
contemptible	despreciable[Adjective]
contemptible	vil[Adjective]
contest	certamen[Noun]
contend	contender[Verb]
contention	contencio/n[Noun]
content	contenido[Noun]
contented	contento[Adjective]
content	satisfecho[Adjective]
contentedness	contentamiento[Noun]
contentedness	contento[Noun]
contented	satisfecho[Adjective]
contentions	contenciones[Noun]
contention	disputa[Noun]
contentment	contentamiento[Noun]
contentment	contento[Noun]
contentions	disputas[Noun]
cool	chevere, chilero[Adjective]
cool	chido
cook	cocer
cook	el cocinero
contest	el concurso
continent	el continente
cookie	la galleta
cookies	las galletas
countable	contable
count	contar
copy	copiar
copper	el cobre
correct	correcto
cork	el corcho
copy	la copia
corduroy	la pana
corn	mai/z
corn	mai/z[Noun]
cost	costar
costume	disfra/s[Noun]
cough	la tos
cough	toser
counterattack	contraataque
countdown	cuenta regresiva
countdowns	cuentas regresivas
counterclockwise	contra las agujas del reloj[Adverb]
counterespionage	contraespionaje[Noun]
counterintelligence	contrainteligencia[Noun]
countermeasure	contramedida[Noun]
counteroffensive	contraofensiva[Noun]
counteroffer	contraoferta[Noun]
counterpart	contraparte[Noun]
counterproposal	contrapropuesta[Noun]
counterrevolutionaries	contrarrevolucionarios[Noun]
cousin	el primo
covenants	alianzas[Noun]
crowded	atestado[Adjective]
crankshaft	ciguenal
cover	cubrir
crab	el cangrejo
coward	el cobarde
cover	la cubierta
cow	la vaca
cowboy	el vaquero
crime	el crimen
cricket	grillo[Noun]
cream	la crema
crazy	loco
crow	el cuervo
crowd	muchedumbre[Noun]
crude	basto[Adjective]
crown	corona[Noun]
curricular	circular
cupulate	copular
cruel	cruel[Adjective]
cucumber	el pepino
crumb	la miga
cry	llorar
crutch	muleta[Noun]
crutches	muletas[Noun]
crying	llorando[Adjective]
cup	la taza
curable	curable
curiosities	curiosidades
cureless	incurable
curfew	no tengo ni puta idea
curiosity	curiosidad
curious	curioso
cut	cortar
cursive	cursiva
curtain	la cortina
dacha	dacha[Noun]
d'art	de arte, arti/stico
d%27etre	de ser
d'etat	de estado[Noun]
d'etre	de ser
dab	lenguado[Noun]
dab	untar, dar palmadas[Verb]
dactylic	dact�lico[Adjective]
dactyl	d�ctilo[Noun]
dad	el papa
dad	padre
daddies	padres[Noun]
daddy	padres
dads	padres
dads	papas[Noun]
daff	bromear[Verb]
daemon	demonio[Noun]
daemons	demonios[Noun]
daemon	espiritu[Noun]
daffodil	narciso[Noun]
daffodils	narcisos[Noun]
day	D�a
date	Fecha
dance	bailar
daft	bobo[Adjective]
damned	condenado[Verb]
dagger	daga[Noun]
daftest	el mas tonto[Adjective]
dafter	mas tonto[Adjective]
daft	zonzo[Adjective]
daftly	locamente[Adverb]
daggerman	dagador[Noun]
daggers	dagas[Noun]
daguerreotype	daguerrotipo[Noun]
daguerreotypy	daguerrotipia[Noun]
daguerreotypes	daguerrotipos[Noun]
daguerreotypic	daguerrot�pico[Adjective]
dahlia	dalia
dahlias	dalias
dalmatian	dalmata[Noun]
daintier	delicado[Adjective]
dailies	diarios[Noun]
daily	todos los dias
dairies	diarios[Noun]
dainty	poquita[Adjective]
dairy	producto la/cteo[Noun]
dally	tardar, perder el tiempo[Verb]
dale	valle[Noun]
dales	valles[Noun]
dalmatians	dalmatas[Noun]
dame	dama[Noun]
damage	da�o[Noun]
dam	represa[Noun]
damaged	da�ado[Adjective]
damask	damasco[Noun]
damaging	da�ando[Adverb]
damages	da�os[Noun]
dammit	maldici�n[Adjective]
dame	mujer[Noun]
damsel	doncella[Noun]
damp	humedo[Adjective]
damped	mojado[Verb]
dancer	bailador[Noun]
dance	el baile
dances	baila
dancers	bailadores
dancing	bailando[Adjective]
databanks	banco de datos
dare	cari�o, querido(a)[Adjective]
dandelion	diente de leon[Noun]
dandelions	dientes de leo/n[Noun]
danger	el peligro
dandruff	la caspa
dangerous	peligroso
dangerously	peligrosamente[Adverb]
dash	corre[Verb]
darkroom	cuarto oscuro[Noun]
darkness	la oscuridad
dark	oscuro
data	datos[Noun]
dashing	hermoso[Adjective]
database	base de datos
daughter	Hija
dated	fechado
date	la fecha
daughters	Hijas
daughter	Nina
daybed	cama dia
dean	decano[Noun]
deactivated	desactivado[Noun]
days	dias
daybook	libro dia
dead	muerto
deaf	sordo
deal	trato[Noun]
debate	debate[Noun]
death	la muerte
dear	querido
debit	debit
decide	decidir
debt	deuda[Noun]
december	diciembre
delicate	delicado
defeat	english[Noun]
defeat	spanish
delicious	delicioso
describe	describir
deluge	diluvio[Noun]
deliver	entregar
dentist	el dentista
democracy	la democracia
deny	negar
desire	desear
desert	el desierto
desperado	desesperado[Noun]
desk	el escritorio
destination	destinacio/n[Noun]
dessert	el postre
desserts	postres[Noun]
destine	destinar[Verb]
destined	destinado[Adjective]
destinies	destinos[Noun]
destiny	destino[Noun]
destroy	destruir
destroyed	destruido[Adjective]
destructible	destructible[Adjective]
destroyer	destruidor[Noun]
destructive	destructivo[Adjective]
destruction	ruina[Noun]
dichotomy	dicotom�a
devil	el diablo
detour	el rodeo
diamond	el diamante
diaper	el panal
dichroic	dicroico
dichroism	dicroismo
dichromatic	dicromatico
dichromatism	dicromatismo
magazine	"What happened? I just wanted to erase ""Almac�n""![Conjunction]"
habitual	"acostumbrado, habitual; empedernido (bebedor, mentiroso)[Adjective]"
e'er	"contracci�n de ""ever"": siempre, alguna vez/ jam�s, nunca en la vida[Adverb]"
didn't	"pasado negativo de ""do"""
dicotyledon	dicotiledon
dicks	pollas (vulg)
dicks	vergas
dictate	dictar, notar (verb), dictamen (Noun)
dictated	dictado[Verb]
dictator	dictador
dictators	dictadores
dictatorial	dictatorial
dictatorially	dictatorialmente
dictatorship	dictadura
dictionary	el diccionario
did	past of do.[Verb]
down	abajo[Adverb]
dockyard	arsenal[Noun]
dock	da/rsena[Noun]
disadvantage	desventaja[Noun]
different	diferente
diehard	duro de matar[Adjective]
die	morir
died	muerto[Verb]
difficulty	dificultad[Noun]
diocese	di�cesis[Noun]
dining room	el comedor
dimple	el hoyuelo
dirty	ensuciar[Verb]
dirtying	ensuciando
dirty	verde[Adjective]
disabilities	incapacidades
disability	inhabilidad
disable	inutilizar[Verb]
disadvantageous	desventajado[Adjective]
docile	do/cil[Adjective]
disaster	el desastre
dish	el plato
do	hacer
dishes	los platos
disrupt	transtornar[Verb]
disrupted	transtornado[Verb]
disrupting	transtornando[Verb]
dockage	muellaje (docking fee)[Noun]
dock	reducir[Verb]
docket	orden del di/a[Noun]
docket	sumario[Noun]
doctor	doctor[Noun]
doctorate	doctornado[Noun]
doctrinaire	doctrinario[Noun]
doctrinal	doctrinal[Adjective]
doctrine	doctrina[Noun]
document	documentar[Verb]
document	document
documental	documental
documentation	documentacio/n[Noun]
documentary	documental[Adjective]
doubt	dudar
donkey	el burro
dog	el perro
dog	la perra
dodder	temblar[Verb]
dogs	las perras
dogs	los perros
doll	mun~eca[Noun]
dolls	mun~ecas[Noun]
dope	la mota[Noun]
door	la puerta
doors	las puertas[Noun]
dorm	la residencia universitaria[Noun]
dormitory	la residencia universitaria[Noun]
dove	la palomita[Noun]
doves	las palomitas[Noun]
drink	beber
dowry	dote[Noun]
dress	el vestido
dozen	la docena
drawer	la gaveta
dream	so�ar[Verb]
dream	sue�o[Noun]
dreams	sue�os[Noun]
dresses	los vestidos[Noun]
drunk	borracho
drink	el refresco[Noun]
drum	el tambor
drinking glass	el vaso
drip	gotear
drug	la droga
drive	manejar
drugstore	la farmacia
duende	duende
duck	el pato
dry	secar
dry	seco
during	durante
e	e
eagre	"creciente de la marea; ola que forma la subida de la marea[Noun]"
eagle	aguila
eager	ancioso
each	cada
eagerly	anciosamente
eager	ansioso[Adjective]
eagerness	ancia
eagerness	ansia
eagles	aguilas
eaglet	aguilucho/ L'Aiglon (el aguilucho), el hijo de Napoleon[Noun]
gutter	"cuneta (en la calle); canal�n (tejado); gotera; arroyo[Noun]"
exhibiting	"exhibiendo; exhibir"
economics	Economica[Noun]
eastward	al este[Adverb]
earrings	aretes[Noun]
earphone	audi/fono[Noun]
earl	conde[Noun]
earache	dolor de oreja
ear	la oreja
ear	oreja
eared	en mazorca, en espiga/ long-eared: de orejas largas[Adjective]
eardrop	espiando
eardrop	gota para oreja[Noun]
eardrum	tambor auditivo
eardrums	t�mpano, membrana del o�do[Noun]
earful	noticias, rumores/arenga, admonici�n[Noun]
earflap	oreja
earldom	condado/ t�tulo, condici�n y propiedad de conde en G.B.[Noun]
earliest	el mas temprano
earlier	mas temprano
earn	ganar
earlobe	lo/bulo[Noun]
earliness	precocidad, anticipaci�n/presteza, prontitud/calidad de temprano[Noun]
earmuff	orejera (protecci�n contra el fr�o)[Noun]
early	temprano
earnest	seriedad, ah�nco, empe�o, intensidad/in earnest: en serio, con seriedad, de veras/[Noun]
earnestly	seriamente/intensamente/de veras[Adverb]
earnestness	seriedad, formalidad (de una persona)/ seriedad, gravedad (de una situaci�n o asunto)[Noun]
earphones	audi/fonos[Noun]
earring	el arete
earring	el aro[Noun]
earplug	tapon de oi/do[Noun]
east	el este
easiest	el mas facil
earthquake	el terremoto
earthquake	el temblor[Noun]
earth	la tierra
earth	tierra
ease	facilidad
earthworm	gusano
earths	las tierras
earthquakes	los terremotos[Noun]
earthquakes	terramotos
earthworms	gusanos
easier	mas facil
easily	facilmente
easter	la Pasqua[Noun]
eat	comer
easy	facil
easy	fa/cil[Adjective]
eaten	comido
eating	comiendo
eatery	el comedor[Noun]
ecology	ecologia
echo	el eco
exhausted	agotado[Adjective]
environment	ambiente[Noun]
enough	bastante
embarrassment	desconcierto, azoramiento[Verb]
economize	economisa/r
economized	economisa/do
economy	econom'ia
educate	educa/r
edge	orilla
educates	educa
educated	educado
effectual	eficaz[Adjective]
elevator	el ascensor
elbow	el codo
egg	el huevo
eight	ocho
eighty	ochenta
elephant	el elefante
electricity	electricidad[Noun]
eleven	once
employee	el empleado
employ	emplear
emerald	la esmeralda
end	el fin
enchilada	enchilada
encompass	englobara[Verb]
enjoy	gozar
england	la Inglaterra
envelope	el sobre
enter	entrar
ermine	armin~o
erase	borrar
envy	envidiar[Verb]
enzymatic	enzim�tico[Adjective]
enzymic	enzim�tico[Adjective]
enzymically	enzimaticamente[Adverb]
enzymologist	enzim�logo[Noun]
enzymology	enzimolog�a[Noun]
eraser	el borrador
example	el ejemplo
exactly	en punto
escape	escaparse
estimate	estimar
europe	la Europa
everyone	todo el mundo[Noun]
everything	todo
excellent	excelente
excited	excitado
exhibit	exhibir
exhibited	exhibido
exhibition	"exhibici�n; exposici�n"
exhibitioner	"exhibicionista; expositor"
exhibitions	"exhibiciones; exposiciones"
exhibitionism	exhibicionismo
exhibitionist	exhibicionista
exhorting	"exhortando; exhortar"
exhibitor	expositor
exhort	exhortar
exhibitors	expositores
exhortation	exhortaci�n
exhortations	exhortaciones
exhorted	exhortado
exhortative	exhortativo
exhortatory	exhortatorio
exhuming	"exhumado; exhumar"
exhorts	exhortos
exhume	exhumar
exhumed	exhumado
exhumer	exhumador
girlfriend	"novia; amiga"
fast	(adj.) ra/pido[Adjective]
fast	(adv.) de prosa ra/pidamente[Adverb]
eye	4280
expensive	caro
exigence	exigencia
exigencies	exigencias
exigency	exigencia
exigent	exigente
exigently	exigentemente
exiguity	exig�edad
exiguousness	exig�edad
exile	exilio
exit	la salida
explode	estallar
explain	explicar
express	expresar[Verb]
expressions	expresiones[Noun]
expressive	expresivo[Adjective]
extending	extendiendo
fall	caer
face	cara
eye	el ojo
fabricate	elaborar[Verb]
fabricate	fabricar[Verb]
eyebrow	la ceja
eyes	los ojos
eyeglasses	ojos
fabulist	fabulista[Noun]
fabulous	fabuloso[Adjective]
fabulously	fabulosamente[Adverb]
fabulousness	fabulosidad[Verb]
facade	fachada[Noun]
faced	enfrentado[Verb]
facet	faceta[Noun]
faction	faccion
facial	facial
facetious	gracioso[Adjective]
facilitate	facilitar[Verb]
facile	vivo[Adjective]
facilitation	facilitacion[Noun]
facility	facilidad[Noun]
facsimile	facsimile[Noun]
facing	paramento[Noun]
fact	realidad[Noun]
factional	faccioso[Adjective]
factious	faccioso[Adjective]
factitious	facticio[Adjective]
faithful	fiel
fair	justo
faith	la fe
fairy	la hada
fallen	caido
farmer	el campesino
fanatic	el fanatico[Noun]
fan	el ventilador
false	falso
falsified	falsificado
family	familia, parientes
fame	la fama
famous	famoso
family	la familia
fanaticism	el fanatacismo[Noun]
fanatical	fanatico[Adjective]
farm	la granja[Noun]
farm	la hacienda
far	lejos
fanatics	los fanaticos[Noun]
frequently	a menudo
forgo	abstenerse de[Verb]
finish	acabar
feverish	afiebrado[Adjective]
feign	aparentar[Verb]
fearless	arrojado[Adjective]
favor	el favor
faucet	el grifo
father	el padre
fat	gordo
favorite	favorito
fear	temer
feature	faccio/n[Noun]
feature	faccion[Noun]
feast	fiesta[Noun]
feather	la pluma
february	febrero
feet	los pies
feel	palpar[Verb]
feel	sensacio/n[Noun]
feeling	sensacio/n[Noun]
feeling	sentimiento[Noun]
fever	calentura[Adjective]
fever	la fiebre
fellow	socio (fellow of a society)[Noun]
fell	tralar[Verb]
fetch	traer[Verb]
fervid	vehemente[Adjective]
fidget	agitarse[Verb]
feverish	febri/l[Adjective]
fiasco	fiasco[Noun]
fewer	menos
few	pocos
fiance	prometido[Noun]
fiancee	prometida[Noun]
fiber	fibra[Noun]
fib	mentirilla[Noun]
fiction	ficcio/n[Noun]
fickle	inconstante[Adjective]
fictitious	ficticio[Adjective]
fictional	novelesco[Adjective]
fictionalize	novelizar[Verb]
fidelity	la fidelidad[Noun]
finally	al fin
file	archivar[Verb]
fiery	ardiente
field	el campo
fiduciary	fiduciario[Noun]
fidgety	inquieto[Adjective]
fierce	feroz[Adjective]
fielder	jardinero[Noun]
fiftieth	cincuentavo (part)[Adjective]
fifteenth	decimoquinto (in a series)[Adjective]
fifteenth	quinzavo (part)[Adjective]
fifth	quinto[Adjective]
fifty	cincuenta
fiftieth	quincauge/simo (in a series)[Adjective]
fig	el higo
figure	figura[Noun]
figure	figurar[Verb]
figs	higos[Noun]
fight	lucha[Noun]
fighter	luchador[Noun]
fight	pelear
figured	figurado[Adjective]
filament	filamento[Noun]
filed	archivado[Adjective]
file	fichero[Noun]
filthy	cochino
filial	filial[Adjective]
fill	llenar
finger	el dedo
find	encontrar
find	hallar
finch	pinz�n, especie de gorri�n, de or�gen europeo[Noun]
fingers	los dedos
footing	andar ( como deporte )[Verb]
firearm	arma de fuego[Noun]
fire	el fuego
fire	la lumbre [Noun]
flagpole	asta[Noun]
five	cinco
fireman	el bombero
fireplace	el hogar
fish	el pescado
fireplace	la chiminea[Noun]
first	primero
fisherman	el pescador
fish	pescado
fishing	pesquero(a)[Adjective]
flagellant	flagelante[Noun]
flag	la bandera
flagellation	flagelacion[Noun]
flagellantism	flagelantismo[Noun]
flagellants	flagelantes[Noun]
flagellar	flagelar[Adjective]
flagpoles	astas[Noun]
flags	banderas[Noun]
food	comida[Noun]
flake	copo[Noun]
flakes	copos[Noun]
fold	doblar
flavor	el sabor
flame	la flama
flannel	la franela
flat	llano
flat	plano
floor	el suelo
float	flotar
flea	la pulga
flight	vuelo[Noun]
flights	vuelos[Noun]
flowerpot	el tiesto
flower	la flor
flour	la harina
foam	la espuma
flu	la influenza
flowers	las flores
fly	la mosca
fly	volar
flying	volando[Verb]
fog	la neblina
foggy	nublado
footage	documental[Noun]
foot	el pie
football	futbol[Noun]
footballer	futbolista[Noun]
forest	el bosque
foreign	extranjero
forehead	la frenta
footnote	nota a pie de p�gina[Noun]
for	para
for	por
footpath	sendero[Noun]
forecast	pronosticar
forgets	olvida[Verb]
forget	olvidarse
forever	para siempre[Article]
forgetful	olvidadizo[Adjective]
forgetfulness	olvido[Noun]
forgive	perdonar
forgiveness	perdo/n[Noun]
forgives	perdona[Verb]
forgiving	perdonador[Adjective]
frequent	adj. frecuente
fortunately	afortunadamente
forlorn	desamparado[Adjective]
fork	el tenedor
forgotten	olvidado[Adjective]
fourteen	catorce
forty	cuarenta
four	cuatro
four	fourty[Adjective]
found	fundar (to found eg. Found a city)[Verb]
found	fundir (to melt or cast eg. to found the steel bars together)[Verb]
fought	luchado[Verb]
fountain	la fuente
fourth	el cuarto
fox	el zorro
free	gratis
france	la Francia
freeze	helar
frequented	adj. asendereado
frequent	va. frecuentar
fresh	adj. fresco
garlics	ajos[Noun]
friendship	amistad[Noun]
friend	el amigo
friday	el viernes
freshen	va. refrescarse
fried	frito
friends	los amigos
friendships	amistades[Noun]
gadgets	artilugio[Noun]
fumble	balbucear[Verb]
fuck	chingar
frozen	congelado
from	de
frighten	espantar
frog	la rana
front	el frente
frost	la escarcha
fruit	la fruta
fucked	chingado[Verb]
fucker	chingador[Noun]
fuckers	chingadores[Noun]
fucking	chingando[Verb]
fuel	combustible
fudge	dulce de chocolate
fucus	enfocar[Verb]
fulfill	completar, lograr
fugue	fuga
fugitive	fugitivo
fulcrum	fulcro
full	completo[Adjective]
fulfiller	cumplidor[Adjective]
fulfill	cumplir
fulfilled	cumpli�, complet�[Verb]
fulfillment	obligacion, deber
fulfillments	obligaciones, deberes
fulsome	de mal gusto[Adjective]
full	lleno
funny	chistoso
fumble	manosear[Verb]
future	el futuro
gang	banda, pandilla[Noun]
game	el juego
gala	gala[Noun]
galaxies	galaxias[Noun]
galaxy	galaxia[Noun]
gallantly	galantemente[Adjective]
gallantry	galanter�a[Adjective]
gallery	galer�a[Noun]
games	juegos[Noun]
garlic	el ajo
garage	el garaje
gangster	pandillero[Noun]
gangsters	pandilleros[Noun]
garden	el jard�n[Noun]
garbage	la basura
gardener	el jardinero
gardens	jardines[Noun]
gator	crocodilibus
gasoline	la gasolina
ghost	el fantasma
generous	generoso
germany	la Alemania
get up	levantarse
get	obtener
getup	levantarse[Verb]
gift	el regalo
gin	la ginebra
giraffe	la jirafa
girl	la muchacha
going	I am going: voy  You are going: va  We are going: vamos  They are going: van[Verb]
girlfriends	amigas
give	dar
girls	las muchachas
glove	el guante
glass	el vidrio
go	ir
glue	la cola
gloves	los guantes
granddad	abuelo[Noun]
goodbye	adios
good	bueno
gold	el oro
goodnight	buenas noches
government	el gobierno
gooseberry	grossella espinosa
gossip	los chismes
grammar	gramatica
grandfather	abuelo
granddaughter	la nieta
grandma	abuela
grandfathers	abuelos[Noun]
grandfather	el abuelo
grandmas	abuelas
grandmothers	abuelas
grandmother	la abuela
grandparent	abuelo[Noun]
gross	asqueroso
graveyard	camposanto[Noun]
grandson	el nieto
gratitude	gratitud[Noun]
grass	la hierba
grapefruit	la toronja
grape	la uva
grandsons	nietos[Noun]
gratuitous	gratuito[Adverb]
gratuities	propinas[Noun]
grave	grave[Noun]
gratuity	propina[Noun]
gravel	grava[Noun]
gravestone	lapida sepulcral[Noun]
graveyards	camposantos[Noun]
groovy	chido
greed	codicia[Noun]
grease	engrasar[Verb]
gravitate	gravitar[Verb]
gravitation	gravitacion[Noun]
gray	gris
great	gran[Adjective]
greasy	grasiento[Adjective]
grease	la grasa
greatly	grandemente[Adverb]
greaten	mejorar[Verb]
greedy	codicioso[Adjective]
greedy	goloso[Adjective]
greedily	vorazmente[Adverb]
grenade	granada[Noun]
greenhouse	inverna/culo[Noun]
green	verde
greenish	verdoso[Adjective]
greens	verdes[Noun]
grenades	granadas[Noun]
grocery store	la bodega
grow	crecer
group	el grupo
group	grupo
guilty	culpable
grownups	gente grande
gruelling	penoso,duro[Adjective]
gut	intestino[Noun]
guitar	la guitarra
guts	intestinos[Noun]
gym	"gimnasio; gimnasia[Noun]"
guzzle	"tragar; engullir[Verb]"
guy	t�o (inf: hombre), tipo[Noun]
guzzled	"tragado; engullido[Adjective]"
gyms	"gimnasios; gimnasias[Noun]"
gymnasium	gimnasio[Noun]
gymnastic	gimnasia[Noun]
gymnasiums	gimnasios[Noun]
gymnast	gimnasta[Noun]
gymnastics	gimnasia[Noun]
gymnasts	gimnastas[Noun]
habit	"h�bito, costumbre; adicci�n (drogas)[Noun]"
haberdasher	camisero[Noun]
gynecological	ginecol�gico/a[Adjective]
gynecology	ginecolog�a[Noun]
gynecologicals	ginecol�gicos/as[Adjective]
gynecologist	ginec�logo/a[Noun]
gynecologists	ginec�logos/as[Noun]
gypsies	gitanos/as[Noun]
gypsy	gitano/a[Noun]
habeas	habeas
ha	ja
haberdasheries	mercer�as[Noun]
haberdashery	mercer�a[Noun]
habits	"h�bitos, costumbres; adicci�nes (drogas)[Noun]"
habits	ha/bitos
habitably	habilidad
habitat	h�bitat[Noun]
habitats	h�bitats[Noun]
madcap	"calavera; botarate; temerario[Noun]"
hack	"cortar; tajar, rebanar[Verb]"
habituates	(se) habitua
habitualize	acostumbrar[Verb]
hacienda	hacienda
haciendas	haciendas
macadam	"s. Piedras trituradas para macadamisar; calzada empedrada con ellas."
laundry	(laundromat) la lavanderi/a[Noun]
harassed	ACOSADA[Adjective]
harass	acosar[Verb]
harass	molestar[Verb]
haggis	morcilla, embutido escoce/s[Noun]
hacker	n.-('haa-ker), one who hacks. Also one who is capable of accessing unauthorized info.    
hacked	pret�rito/participio pasado de hack[Verb]
hadn't	no ha
hackle	pelo erizado
hacker	pirata inform�tico[Noun]
hackers	piratas inform�ticos[Noun]
had	pret�rito/participio pasado de have[Verb]
had	yo teni/a (I had)[Verb]
haggard	ojeroso[Adjective]
happen	pasar
hairdresser	peluquero[Noun]
haggled	pret�rito/participio pasado de haggle[Verb]
haggle	regatear[Verb]
hailstorm	tormenta de granizo[Noun]
hairdressers	peluqueros[Noun]
halfcircle	semicirculo
harlequin	Arlequ�n[Noun]
harem	Har�m[Noun]
hare	Liebre[Noun]
hardware	circuitos[Noun]
hard	difi/cil[Adjective]
harbor	puerto[Noun]
hardness	dureza
hard	tieso[Adjective]
harelipped	Leporino (labio)[Adjective]
harebrained	Tonto[Adjective]
hares	Liebres[Noun]
harlequinade	Arlequinada[Noun]
harmonic	Arm�nico[Adjective]
harm	Da�ar[Verb]
harmed	Da�ado[Verb]
harmful	Da�ino[Adjective]
harmless	Inofensivo[Noun]
harmonica	Arm�nica (Inst.M�s.)[Noun]
harmonium	Armonio (Inst.Musical)[Noun]
harmonical	Arm�nica[Adjective]
harmonize	Armonizar[Verb]
help	Ayuda[Noun]
helmet	Casco[Noun]
helmet	casco
headache	dolor de cabeza
head	doument
he	e/l[Pronoun]
hat	el sombrero
have	haber[Verb]
hate	odiar
haze	la bruma[Noun]
haven't	no tener[Verb]
have	tener
hazardous	peligroso[Adjective]
headaches	dolores de cabeza
heat	el calor
health	health
health	salud
headline	ti/tulo[Noun]
headdress	tocado[Noun]
healthy	sano
helicoidal	helicoidal[Adjective]
heiresses	herederas[Noun]
height	la altura
heavy	pesado
heirloom	herencia (objeto valioso familiar)[Noun]
heliogram	heliograma[Noun]
heliograms	heliogramas[Noun]
hello	hola
hello world	hola el mundo
hello	que tal
helped	Ayudado[Adjective]
help	ayudar
helper	Ayudante[Noun]
helpers	Ayudantes[Noun]
helper	ayudante[Noun]
horse	CABALLO
high	alto
hen	la gallina
helpful	u/til[Adjective]
house	CASA
hot	caliente
horse	el caballo
hospital	el hospital
horses	los caballos
hotel	el hotel
hotdogs	el pancho[Noun]
hour	la hora
hotels	los hoteles[Noun]
hours	las horas
internetwork	Connecci�n interna de comunicaci�n
incant	Encantar[Verb]
humdrum	aburrido[Adjective]
house	casa[Noun]
houses	casas
humanity	humanidad[Noun]
humble	humilde[Adjective]
humble	humillar[Verb]
humans	los humanos[Noun]
icing	alcorza, escarchado[Noun]
hummingbird	colibri/[Noun]
humiliate	humillar[Verb]
humidity	la humedad
icicle	el cara/mbano[Noun]
husband	el esposo
hunger	la hambre
ice cream	el helado
ice	el hielo
iambic	ia/mbico[Adjective]
i	yo
ibis	ibis[Noun]
iced	escarchado (cake)[Adjective]
iceberg	iceberg[Noun]
icebox	la refrigeradora[Noun]
icebergs	t�mpano[Noun]
icily	icon�grafo
iciest	lo ma/s helado[Adjective]
icicles	los cara/mbanos
icier	ma/s helado[Adjective]
in agreement	de acuerdo
icon	el i/cono[Noun]
idiom	el idioma[Noun]
iconographical	eth
iconoclast	iconoclasta
iconoclastic	iconoclasta[Adjective]
iconoclastic	iconocl�stico
iconoclastically	iconocl�sticamente
iconographer	icon�grafo[Noun]
iconographic	rhtrhyhgf
icons	iconos[Noun]
ideal	ideal[Adjective]
idea	la idea
ideates	idea[Verb]
idealism	idealismo[Noun]
ideals	ideales[Noun]
idealist	idealista[Adjective]
idealization	idealizaci�n[Noun]
idealizations	idealizaciones[Noun]
idealizes	idealiza[Verb]
idealize	idealizar[Verb]
idealized	idealizado[Adjective]
ideas	ideas[Noun]
ideate	idear[Verb]
identic	id�ntico[Adjective]
idem	�dem
identical	id�ntico[Adjective]
identically	id�nticamente[Adverb]
identifiable	identificable[Adjective]
identification	identificaci�n[Noun]
identifications	identificaciones[Noun]
idiot	idiota
implement	implantar[Verb]
if	si
implementation	implantaci�n
important	importante
imported	importado
impossible	imposible
impressive	impresionante[Adjective]
incalculable	incalculable
inborn	innato(a)[Adjective]
incalculably	incalculable[Adjective]
incantation	Encantaci�n
incantations	Encantaciones
incanted	Encantado(a)
incapacitate	Incapacitar[Verb]
incapable	incapaz
incapacitates	Incapac�ta
incapacitated	incapacitado[Adjective]
incidentals	a music notacion symbol
incaution	descuido[Verb]
incarcerate	encarcelar[Verb]
incapacity	incapacidad[Adjective]
incarcerated	encarcelado
incarceration	encarcelaci�n
incarcerating	encarcelando
incarcerates	encarc�la
incarnate	encarnar[Verb]
incarnation	renacer
incarnations	renacimientos
incautious	descuidado(a)
incautiously	descuidadamente
incautiousness	descuidado(a)[Adjective]
inching	despacio[Adverb]
incendiaries	incendiarios(as)[Adjective]
incendiary	incendiario(a)[Adjective]
incense	incienso[Noun]
incensed	inciensado(a)
incenses	inciensa[Verb]
incentive	incentivo[Noun]
incensing	inciensando[Verb]
incentives	incentivos
incessant	incesante[Adjective]
incertitude	incierto[Adjective]
incessantly	incesantemente[Adjective]
incest	incesto[Noun]
incestuous	incestuoso(a)[Adjective]
incestuously	incestuosamente[Adjective]
incestuousness	incestuosidad[Adjective]
inch	pulgada[Noun]
inches	pulgadas[Noun]
inchworm	gusano medidor[Noun]
inchworms	gusanos medidores[Noun]
incidence	incidencia[Noun]
incidences	incidencias[Noun]
incident	incidente[Noun]
incidental	incidental[Adjective]
incidentally	incidentalmente[Adjective]
increase	aumentar
incidents	incidentes[Noun]
incinerate	incinerar[Verb]
incinerated	incinerado[Adjective]
incinerates	incinera[Verb]
incineration	incineraci�n[Adverb]
incinerating	incinerando[Verb]
incinerations	incineraciones[Adverb]
incinerator	incinerador[Noun]
incinerators	incineradores[Noun]
incise	inciso[Noun]
incision	incisi�n[Noun]
incises	incisos[Noun]
incisions	incisiones[Noun]
incisor	incisor[Noun]
incitant	incitante[Adjective]
incitation	incitaci�n[Noun]
incitants	incitantes[Adjective]
incitations	incitaciones[Noun]
incites	incita[Verb]
incitement	incitamiento[Noun]
incite	incitar[Verb]
incited	incitdo(a)[Adjective]
incitements	incitamientos[Noun]
inciter	incitar[Verb]
inciting	incitante[Adjective]
inclemency	inclemencia[Noun]
inclement	inclemente[Adjective]
inclemently	inclementemente[Adjective]
inclinable	inclinable[Adjective]
inclination	inclinaci�n[Noun]
inclinations	inclinaciones[Noun]
incline	inclinar[Verb]
inside	dentro
innocent	el inocente[Noun]
information	informacion
informant	informante
innocence	la inocencia[Noun]
ink	la tinta
insect	el insecto
innocent	inocente[Adjective]
inoffensive	inofensivo, inofensiva[Adjective]
insult	el insulto
insult	insultar
intelligent	inteligente
interesting	interesante
intern	interno(a)[Adjective]
internality	internalidad[Adjective]
internal	interno(a)[Noun]
international	internacional[Adjective]
internalization	internalizaci�n[Noun]
internalizes	internaliza[Verb]
internalize	internalizar[Verb]
internalized	internalizado[Adjective]
internalizing	internalizando[Verb]
internally	internamente[Adjective]
internals	internos(as)[Adjective]
internationalization	internaciionalizaci�n[Noun]
internationalism	internacionalismo[Noun]
internationality	internacionalidad[Adjective]
internationalist	internacionalista[Adjective]
internationalists	internacionalistas[Adjective]
internationals	internacionales[Adjective]
internationalize	internacionalizar[Verb]
internationalized	internacionalizado(a)[Adjective]
internationalizes	internacionaliza[Verb]
internationally	internacionalmente[Adjective]
keeper	Guardi�n, custodio
italy	Italia
iron	el hierro
interweave	entretejer[Verb]
interneuronal	interneuronal[Adjective]
interneuron	neuron interno[Noun]
internetwork	trabajo en la RIM (Red Mundial Interna)[Noun]
interning	internando[Verb]
intervention	intervencio/n[Noun]
interview	la entrevista
intimate	i/ntimo[Adjective]
intimacy	intimidad[Noun]
intimidate	intimidar[Verb]
introduction	introducci�n[Noun]
introductions	introducciones
invite	invitar
island	la isla
iron	planchar
jabber	algarab�a
j	j
jab	pinchazo
jackboot	bota de montar, bota militar[Noun]
jackass	burro[Noun]
jackal	chacal[Noun]
jack	gato, para sujetar el coche cuando se cambia una rueda[Noun]
jackals	chacales
jackpot	bote, premio m�ximo[Noun]
jackdaw	grajilla, grajo
jacket	la chaqueta
jackknife	navaja
jackhammer	taladradora, martillo picador
kaleidoscope	caleidoscopio
jealous	celoso
jagged	dentado, mellado, disigual[Adjective]
jade	jade
jackpot	premio m�ximo
jag	punta, pu�[Noun]
jag	raja
janitor	el conserje
jail	jaula[Noun]
january	enero
jar	la jarra
judge	el juez
joke	la broma
jewel	la joya
jeans	vaqueros[Noun]
jewels	las joyas
job	trabajo[Noun]
juice	el jugo
juice	joco[Verb]
july	julio
june	junio
jump	saltar
jungle	la selva
kangaroo	canguro[Noun]
kangaroos	canguros[Noun]
karma	carma
karat	kilate
karate	karate
karateist	karateca
keep	guardar
keep	manutenci�n, subsistencia
keel	quilla[Noun]
labor	Parto (childbirth)[Noun]
kneel	arrodillarse[Verb]
killer	asasino[Noun]
kick	cocear
keeping	custodia, cuidado
key	la llave
key	llave
keys	llaves
keyboard	tecla[Noun]
kill	matar
kidnap	seguestar
killed	matado[Adjective]
killers	asasinos
kiss	besar
king	el rey
kilo	kilo
kilobit	kilobit
kilometer	kil�metro[Noun]
kilometers	kil�metros
kindness	la bondad
kiosk	kiosko
kingdom	reino[Noun]
kingdoms	reinos[Noun]
kings	reyes
kisses	besos[Noun]
kitten	el gatito
kitchen	la cocina
knee	la rodilla
knight	caballero
knife	el cuchillo
knife	la navaja
knees	rodillas
knew	sabia, supo[Verb]
knights	caballeros[Noun]
known	conocido[Adjective]
knowledge	conocimiento[Noun]
know	saber[Verb]
knock	tocar
knockdown	tumbar
label	el marbete
label	etiqueta
kooks	�ppou
labeled	etiquetado
labelled	etiquetado
labeling	marcando
labels	etiquetas
labia	labia[Noun]
labile	la/bil
labial	labial
labial	labial[Adjective]
labialization	labializacion[Noun]
labiodental	labiodental[Adjective]
labium	labio[Noun]
laborsaving	Que ahorra trabajo[Adjective]
laborist	el laborista[Noun]
laborer	jornalero[Noun]
laborable	laborable
labor	trabajo
laboratories	laboratorios
laboratory	laboratorio
laborers	jornaleros[Noun]
laborer	obrero[Noun]
laboring	laborando[Verb]
laborers	obreros[Noun]
laborious	laborioso
laboriously	laboriosamente
laborious	tabajoso[Adjective]
laborite	laborista[Noun]
laborists	los laboristas[Noun]
laborites	laboristas[Noun]
laid	acostado[Adjective]
ladylike	afeminado[Adjective]
lackadaisical	apatico[Adjective]
laces	cintas[Noun]
lace	el encaje
lace	la cinta[Noun]
labyrinth	laberinto
labradorite	labradorita[Noun]
labs	los laboratorios[Noun]
labyrinths	laberintos
lac	laca
lacerate	lacerar[Verb]
lacerated	lacerado[Adjective]
lacerates	lacera[Verb]
laceration	laceracion[Noun]
lacerating	lacerando[Verb]
lacerations	laceraciones[Noun]
lacework	encajes[Noun]
lack	escasez[Noun]
lack	falta, carencia
lachrymal	lagrimal
lachrymal	lacrimal[Adjective]
lachrymator	lacrimogeno[Noun]
lachrymose	lloron, llorona[Adjective]
lachrymose	lloroso[Adjective]
lackadaisically	apaticamente[Adverb]
laded	cargado
lade	cargar (to load in shipping)[Verb]
lad	chico[Noun]
lacked	faltaba[Verb]
lacking	faltar (something is lacking/algo falta)[Verb]
lackey	lacayo (sirviente)[Noun]
lackeys	lacayos (sirvientes)[Noun]
lacquer	laca
laconism	laconismo[Noun]
laconic	lac�nico[Adjective]
lacks	le falta[Verb]
lackluster	sin brillo[Adjective]
laconisms	laconismos[Noun]
laconize	lac�nizar[Verb]
laconized	la�nizados[Adjective]
lactase	lactasa
lacquer	pintar con laca[Verb]
lactate	lactar[Verb]
lactate	lactato
lacuna	laguna[Noun]
lactic	l�ctico[Adjective]
lacunae	lagunas[Noun]
ladder	escalera
ladder	escala[Noun]
lad	muchacho
ladders	escalas[Noun]
ladders	las escaleras[Noun]
laden	cargado[Adjective]
ladybug	catarina
lads	chicos[Noun]
ladle	cucharon[Noun]
ladies	damas
ladles	cuchorones[Noun]
ladling	sirviendo con cucharones[Verb]
lady	dama
lads	muchachos
ladybird	mariquita[Noun]
ladybirds	mariquitas[Noun]
ladybugs	catarinas
ladyfinger	lengua de gato (biscuit)
ladybugs	mariquitas[Noun]
ladylove	amada[Noun]
ladylike	fina, distinguida[Adjective]
lag	atrasarse
ladyship	se~noria[Noun]
lager	cerveza dorada[Noun]
lagers	cervezas doradas[Noun]
laicizes	da caracter laico
laicize	dar caracter laico
lagomorph	lagomorfo
lagged	retrasado
laggard	rezagado[Adjective]
laggardly	rezagadamente[Adverb]
lagger	vago, vaga[Noun]
lagoon	laguna
lagoons	lagunas[Noun]
laic	laico, laica[Adjective]
laicism	laicismo[Noun]
laicization	laicizacion[Noun]
laicizations	laicizaciones[Noun]
laicized	dio caracter laico
lamb	cordero, borrego, oveja
lake	el lago
lair	la guarida[Noun]
laid	recostado
laity	seglares[Noun]
laird	terrateniente[Noun]
lakefront	en la orilla del lago[Adjective]
lake	lago
lam	huida[Noun]
lakeshore	la orilla del lago[Noun]
lakes	lagos[Noun]
lama	lama (monje)
lamas	lamas 
laudable	digno de loor[Adjective]
last	durar[Verb]
lamb	el cordero
landlord	el duen~o[Noun]
landlady	la duen~a[Noun]
lamp	la la/mpara[Noun]
land	la tierra[Noun]
lance	lanza[Noun]
lance	lanzar[Verb]
lances	lanzas[Noun]
language	el lenguaje[Noun]
landlords	los duen~os[Noun]
large	grande[Adjective]
language	la lengua
lapel	la solapa[Noun]
lanterns	las la/mparas[Noun]
languages	las lenguas[Noun]
lapels	las solapas[Noun]
lass	la muchacha
lasses	las muchachas
laud	loor[Noun]
late	tarde
last	ultimo
laundress	la lavadera[Noun]
laughter	la risa[Noun]
laugh	reir
laugh	reirse[Verb]
laughing	riendo
launder	lavar (ropa)[Verb]
letter	(of the alphabet) la letra[Noun]
letter	a
learn	aprender
lawyer	el abogado
lavatory	el ban~o[Noun]
laundryman	el lavadero[Noun]
laurel	el laurel[Noun]
lawn	el cesped[Noun]
lawn	el prado
law	la ley
law	la suegra
lawless	sin ley[Adjective]
laws	las leyes[Noun]
leader	el li/der[Noun]
lead	el plomo
lazy	guapo[Adjective]
lazy	perezoso
leaflet	el librito
leaf	la hoja
leap	el salto[Noun]
leap	saltar[Verb]
ledge	borde, anaquel[Noun]
lecturer	conferensista[Noun]
leash	correa[Noun]
leathern	de cuero[Adjective]
leather	el cuero
leaves	las hojas[Verb]
leave	salir
legalist	el legalista[Noun]
left	izquierdo
leech	sanguijuela[Noun]
lee	sotavento[Noun]
ledger	travesa�o, andamio[Noun]
leg	la pierna
lefties	surdos, surdas[Noun]
lefty	surdo, surda[Noun]
legal	legal[Adjective]
lesbianism	el lesbianismo
lemon	el limo/n[Noun]
leisure	el ocio
legend	la leyenda[Noun]
legalize	legalizar[Verb]
legends	las leyendas[Noun]
legs	las piernas
lenses	lentes[Noun]
lemonade	limonada[Noun]
lemons	limones[Noun]
lend	prestar
lesson	la leccio/n[Noun]
lesbians	las lesbianas
less	menos
macabre	a. Macabro[Adjective]
loathe	aborrecer[Noun]
lift	alzar
liberalism	el liberalismo[Noun]
liar	el mentiroso
level	el nivel[Noun]
lettuce	la lechuga
levels	los niveles[Noun]
liable	responsable[Adjective]
liberator	el libertador[Noun]
liberation	la liberacio/n[Noun]
liberate	liberar[Verb]
library	la biblioteca
liberty	la libertad[Noun]
libraries	las bibliotecas[Noun]
license	la licencia[Noun]
lice	los piojos[Noun]
lid	la tapa
lick	lamer
life	la vida
lie	mentir
lie	yacer[Verb]
little	chico[Adjective]
like	como[Adverb]
ligament	el ligamento[Noun]
lightening	el rela/mpago[Noun]
lightbulb	la bombilla
light	la luz
lightning	el rela/mpago[Noun]
lightening	la la/mpara[Noun]
lip	el labio
limit	el li/mite[Noun]
like	gustar
lime	la lima
limes	las limas[Noun]
lime	uni
limitation	la limitacio/n[Noun]
limit	limitar[Verb]
limitations	las limitaciones[Noun]
lion	le�n[Verb]
limited	limitado, limitada[Adjective]
linoleic	linoleico[Noun]
limitless	sin li/mites[Adjective]
linoleum	lin�leo[Noun]
liquor	el licor
lipidic	lip�dico[Adjective]
lipid	l�pido[Noun]
lips	los labios
lipids	l�pidos[Noun]
listen	escuchar
list	la lista
literature	la literatura
literally	woertlich
live	directo[Adjective]
littler	menor
little	poco[Adjective]
littlest	menor
loan	el pre/stamo[Noun]
liver	hi/gado[Noun]
liver	hi/gados[Noun]
live	vivir
lived	vivido
loaf	holgazanear[Verb]
load	la carga[Noun]
living room	la sala
lizard	lagarto[Noun]
loads	las cargas[Noun]
lovely	adorable[Adjective]
lofty	alto[Adjective]
locker	el casillero[Noun]
loch	el lago[Noun]
lobe	el lo/bulo[Noun]
lobby	el vesti/bulo[Noun]
lobster	la langosta
location	la situacio/n[Noun]
lobsters	las langostas[Noun]
local	local[Adjective]
locate	localizar[Verb]
locals	los vecinos[Noun]
lock	la cerradura
lock	la esclusa[Noun]
locksmith	el cerrajero[Noun]
lockout	el lockout[Noun]
locket	el medallo/n[Noun]
lockers	los casilleros[Noun]
loft	el desva/n[Noun]
lodge	la casa del guarda[Noun]
locust	la langosta[Noun]
locomotive	la locomotora[Noun]
locusts	las langostas[Noun]
love	amar
love	love
look at	mirar
loll	rapantigarse[Verb]
loiter	vagar[Verb]
lone	solitario[Adjective]
lonely	solitario[Adjective]
look	ver[Verb]
looking	mirando
lose	perder
loose	suelto
loom	telar[Verb]
looking	viendo[Verb]
looser	sueltos[Adjective]
lost	perdido
loud	ruidoso
luckily	afortunadamente[Adverb]
lover	amante[Noun]
luck	la suerte
luck	suerte
lunch	almorzar (v)
lunch	el almuerzo
lucrative	lucrativo[Adjective]
luckiness	suerte[Noun]
lucratively	lucrativamente[Adverb]
lucre	lucro[Noun]
lucubrate	lucubrar[Verb]
lucubration	lucubracio/n[Noun]
lukewarm	tibio
luxury	el lujo
ma	mama/[Noun]
ma'am	s.  Contradiccion de madam,senora.
ma'am	sen~ora[Noun]
macabrely	de manera macabra
macabre	macabro
macadamized	alquitranado[Adjective]
macadamize	macadamizar[Verb]
mackerel	caballa
machinelike	como maquina
macaw	lapa
macaque	macaco[Noun]
macarize	macarron[Verb]
macarized	macarronismo[Noun]
macarizes	macarrona[Verb]
macarizing	macarronico, ca[Adjective]
macaroni	macarrones
macaronic	macarronico
macaronically	macarronicamente[Adverb]
macaronies	macarrones[Noun]
macaroon	macarr�n
macaws	lapas
machine	m'aquina
macerate	macerar
mace	mazo[Noun]
macerated	macerado
macerates	macera
maceration	maceracio/n
macerating	macerando
macerations	maceraciones
macerator	macerador
macerators	maceradores
machete	machete
machinability	maquinabilidad[]
machinates	maquina
machinable	maquinable
machinate	maquinar
machinated	maquinado
machination	maquinaci�n[]
machination	maquinacio/n
machinating	maquinando
machinator	maquinador
machineable	maquinable
machine	m�quina[]
machined	maquinado
machines	m'aquinas
machineries	maquinarias
machinery	maquinaria
machismo	machismo
machining	maquinando[Verb]
machines	m�quinas[]
machinist	maquinista
machinists	maquinistas
macho	macho
macintosh	macintosh
mackerels	caballas
madam	dama[Noun]
mad	enojado
mad	loco,chiflado,majara,majareta[Adjective]
mackintosh	mackintosh[Noun]
macro	macro
macroaggregate	macroagregar[Verb]
macroaggregated	macroagregado[Adjective]
macrobiotic	macrobiotico
macrocephalic	macroencefalico
macrocephalous	macrocefalo[Adjective]
macrocephaly	macrocefalia[Noun]
macrocosm	macrocosmo
macrocosmic	macrocosmico
macrocosmically	macrocosmicamente
macrodynamic	macrodinamica
macroeconomic	macroeconomico
macroeconomics	macroeconomia
macroevolution	macroevolucion[Noun]
macrostructural	macroestructural
macrofossil	macrofosil[Noun]
macroinstruction	macroinstrucci�n[Noun]
macromolecular	macromolecular[Adjective]
macromolecule	macromolecula[Noun]
macromolecules	macromoleculas[Noun]
macronucleus	macronucleo[Noun]
macronutrient	macronutriente[Noun]
macropathological	macropatol�gico[Adjective]
macropathology	macropatolog�a[Noun]
macrophage	macr�fago[Adjective]
macroprocessor	macroprocesador[Noun]
macrosocioeconomic	macrosocioecon�mico[Noun]
macrostructure	macroestructura
maculate	manchar[Verb]
maculated	manchado,sucio
madams	damas[Noun]
maestro	arista eminent en cualquiere de las bellas artes[Noun]
made	hecho[Adjective]
maddest	lo m/as enfadado[Adjective]
madder	m/as enfadado[Adjective]
madly	locamente[Adjective]
madhouse	manicomio[Noun]
mademoiselle	se�orita[Noun]
mademoiselles	se�oritas[Noun]
madman	loco[Noun]
madmen	locos[Noun]
madness	locura, chifladura[Adjective]
madwoman	mujer loca[Noun]
mafioso	niembre de la mafia[Noun]
meatball	"alb""o/""ndigas[Noun]"
magisterial	"authoritario; dominante; pomposo"
maggoty	"caprichoso; quimerico[Adverb]"
maggot	"cresa; gusano; larva[Noun]"
magenta	"rojo purpureo; solferino[Adjective]"
magazine	la revista
magazines	las revistas[Noun]
magi	"los Reyes Magos; sacredotes de la relig. zoroastrica[Noun]"
magic	ma/gico
magical	ma/gico
magic	magia[Noun]
magician	mago
magically	m�gicamente[Adjective]
magicians	magos
mailbox	apartado postal
mail	el correo
magnet	ima/n
magistracy	jurisdiccion de magistrado
magisterially	magistralmente
magisterium	magistreio o autoriad delo
magma	lava volcanica[Noun]
magma	magma
magnanimity	magnanimosidad[Noun]
magnanimously	magnanimosamente[Adjective]
magnanimous	magn�nimo[Adjective]
magnesia	magnesio(a)
magnate	potentado
magnesium	magnesio[Noun]
maid	la criada
magnetic	magne/tico
magnetically	magneticamente[Adjective]
magnetism	magnetismo[Noun]
magnetisms	magnetismo[Noun]
magnific	magn�fico[Adjective]
magnifically	magn�ficamente[Adjective]
magnificence	magnificencia[Noun]
magniloquence	magnilocuencia[Noun]
magniloquent	magnilocuente[Adjective]
magniloquently	magnilocuentemente[Adjective]
magnitude	magnitud[Noun]
magnitudes	magnitudes[Noun]
magnolia	magnolia[Noun]
magnolias	magnolias[Noun]
maiden	soltera[Noun]
maidenhood	solteri/a[Noun]
mal	bad[Adjective]
mailbox	buzo/n
mailboxes	buzones
mailman	el cartero
make	hacer
mainly	principalmente
married	casado
malnutrition	desnutricio/n[Noun]
malleability	maleabilidad
malignant	maligno[Adjective]
mallet	mazo[Noun]
manager	el gerente
man	el hombre
mammals	mami/feros[Noun]
mammary	mamaria
mammography	mamografi/a[Noun]
management	gerencia[Noun]
man	vero/n[Noun]
map	el mapa
mancipation	emancipacio/n[Noun]
managerially	gerencialmente[Adverb]
managers	gerentes[Noun]
maneuverer	maniobrador
maneuvers	maniobras
many	muchos
market	el mercado
march	marzo
marry	casarse
meat	la carne
meal	la comida
mayonnaise	la mayonesa
mask	ma/scara[Noun]
may	mayo
meals	las comidas
measurement	medicion[Noun]
move	(household) mudarse[Verb]
millennium	3012
medley	baturrillo[Noun]
medium	intermedio[Adjective]
medium	medio[Noun]
meditations	meditaciones[Noun]
meditate	meditar[Verb]
mediums	medios[Noun]
medleys	baturrillos[Noun]
medley	mezcolanza[Noun]
meek	do/cil[Adjective]
medleys	mezcolanzas[Noun]
meekness	docilidad[Noun]
meek	paciente[Adjective]
message	el mensaje
meets	encontra[Verb]
meet	encontrar[Verb]
meekness	mansedumbre[Noun]
meeting	encuentro[Noun]
meet	ser presentado a[Verb]
meetings	encuentros[Noun]
meetings	reuniones[Noun]
memory	la memoria
megabyte	mega-byte[Noun]
men	los hombres
milk	la leche
midnight	la medianoche
mi	me
metalize	shgfhg
mile	la mila
motionless	ESTATICO[Adjective]
mother	MADRE[Noun]
money	el dinero
mirror	el espejo
minute	el minuto
monday	el lunes
miss	extran~ar[Verb]
mischievous	travieso[Adjective]
mistake	la falta
mixture	la mezcla
modern	moderno
mood	el humor
month	el mes
monkey	el mono
months	los meses[Noun]
mop	gerga[Noun]
moon	la luna
mortgage	hipoteca[Noun]
more	ma/s[Adjective]
mopper	trapeador[Noun]
mopping	trapear[Verb]
morning	man~ana[Noun]
moribund	moribundo
mornings	man~anas[Noun]
morphologic	morfolo/gico[Adjective]
mortality	mortalidad[Noun]
mortals	mortales
mortally	mortalmente[Adverb]
mortgaged	hipotecado[Adjective]
mortgager	hipotecario
mortgages	hipotecas[Noun]
motion	MOVIMIENTO[Noun]
mother	la madre
motions	MOVIMIENTOS[Noun]
motivated	MOTIVADO[Adjective]
motivation	MOTIVACION[Noun]
motivating	MOTIVANTE[Adjective]
motor	MOTOR[Noun]
moustache	el bigote[Noun]
motorcycle	la motocicleta
mouse	laucha
mouse	rato/n
mouthwash	el enjuague
mouth	la boca
moustaches	los bigotes[Noun]
o'clock	En punto
now	ahora
nourish	alimentar[Verb]
nice	amable
murder	asesinar
mud	el barro[Noun]
mud	el lodo
movement	el movimiento[Noun]
move	mover(se)[Verb]
movie	la peli/cula[Noun]
movements	los movimientos[Noun]
much	mucho
mulberry	la mora[Noun]
multitudes	las multitudes[Noun]
multiply	multiplicar[Verb]
multiplying	multiplicando[Verb]
municipalities	las municipalidades[Noun]
munch	masticar[Verb]
municipal	municipal[Adjective]
near	cerca
nails	clavos[Noun]
murder	el asesinato
mustache	el bigote
mushroom	el hongo[Noun]
muscle	el mu/sculo[Noun]
murmur	murmurar[Verb]
museum	el museo
muscles	los mu/sculos[Noun]
muscular	muscular[Adjective]
musician	el mu/sico[Noun]
music	la mu/sica[Noun]
musical	musical[Adjective]
musicologist	el musico/logo[Noun]
musicians	los mu/sicos[Noun]
nail	el clavo
nail	un~a[Noun]
nasty	desagradable[Adjective]
naked	desnudo[Adjective]
naive	ingenuo[Adjective]
nails	un~as[Noun]
naively	ingenuamente[Adverb]
naiveness	ingenuidad[Noun]
nakedly	desnudamente[Adverb]
nakedness	desnudez[Noun]
name	el nombre
narrow	estrecho
napkin	la servilleta
nap	la siesta
names	michael
nanosecond	nanosegundo[Noun]
namesake	tocayo[Noun]
nanoseconds	nanosegundos[Noun]
naphtha	nafta[Noun]
napalm	napalm[Noun]
narcissism	narcisismo[Noun]
napkins	servilletas[Noun]
narcissist	narcisista[Adjective]
narcissist	narcisista[Noun]
narcissistic	narcisista[Adjective]
narcissus	narciso[Noun]
narcolepsy	narcolepsia[Noun]
narcotic	narco/tico
narcotics	narco/ticos
narrate	narrar[Noun]
narrated	narrado[Verb]
narrate	narrar[Verb]
narration	narracio/n[Noun]
narrator	narrador[Noun]
narrational	narrativo, narrativa[Adjective]
narrowing	estrechando[Adverb]
nation	nacio/n[Noun]
national	nacional
nationalities	nacionalidades
nationality	nacionalidad
nationalization	nacionalizacio/n
nationalize	nacionalizar
natural	naturalis
naturalism	natu
nature	naturaleza[Noun]
nearby	cerca[Adjective]
nearby	cerca[Adverb]
necklace	el collar
neck	el cuello
necessary	necesario
neat	pulcro
newest	el mas nuevo
nest	el nido
nephew	el sobrino
neighbor	el vecino
necklaces	gargantillas
needle	la aguja
necktie	la corbata
nectar	nectar
need	necesitar
negation	negatio/n
negative	negativo
negotiable	negociable
negotiates	negocia
negotiant	negociante
negotiated	negociado
negotiate	negociar
negotiating	negociando
neighborhood	el vecindario
neighbor	la vecina[Noun]
neighborhoods	vecindades
nervous	nervioso
net	la red[Noun]
newer	mas nuevo
nevertheless	no obstante
never	nunca
new	nuevo
news	las noticias[Noun]
noticeable	conspicuo[Adjective]
notebook	cuaderno
north	el norte
noise	el ruido
night	la noche
niece	la sobrina
nightmare	la pesadilla
nobody	nadie
ninety	noventa
nine	nueve
nipple	pezon
nipples	pezones
none	ninguno
notebooks	cuadernos
nothing	nada
notice	notar[Verb]
notice	prestar atencio/n[Verb]
noun	el sustantivo
noun	substantivo
nourishing	alimenticio[Adjective]
nourish	nutrir[Verb]
novel	la novela
nourishment	nutrimento
nourishment	sustento[Noun]
november	noviembre
nurse	la enfermera
nuance	matiz[Noun]
nuances	matices[Noun]
nystagmus	nova
o	or[Conjunction]
oatcake	Pastel de avena
oaks	Robles
oaken	de roble[Adjective]
o'clock	en punto
oaf	palurdo, patan, zoquete[Noun]
oak	roble
oat	avena
oakwood	madera de roble
oaks	robles
oasis	oasis
oar	remo
oars	remos
oiled	aceitado
off	apagado
oceanarium	aquario
oats	avena
oath	juramento
oaths	juramentos
object	el objeto
obese	gordo/gorda[Adjective]
obedience	obediencia
obbligato	obligado[Adjective]
obdurate	terco[Adjective]
obduracy	terquedad[Noun]
obdurately	tercamente[Adverb]
obediences	obediencias
obedient	obediente
obediently	obedientemente
obelisk	obelisco
obey	obedecer
obese	obeso
obesity	obesidad
obeys	obedece
obeyed	obedecio[Verb]
obeying	obedeciendo[Verb]
obfuscate	ofuscar
obfuscated	ofuscado
obfuscation	ofuscacion
obfuscating	ofuscando
oblique	english
objected	objetado[Adjective]
objection	objecio/n[Noun]
objectionable	objetable[Adjective]
objections	objeciones[Noun]
objective	objetivo[Adjective]
objectively	objetivamente[Adverb]
objectiveness	objetividad[Noun]
objector	objetor[Noun]
objet	objeto[Noun]
objectors	objetores[Noun]
objects	objetos[Noun]
obligation	obligacio/n[Noun]
obligate	obligar[Verb]
objurgate	reprender[Verb]
objurgated	reprendido[Adjective]
obligated	obligado[Adjective]
obligately	obligatoriamente[Adverb]
obligations	obligaciones[Noun]
obligational	obligatorio[Adjective]
obliged	obligado[Adjective]
oblige	obligar[Verb]
obligatory	obligatorio[Adjective]
occiput	nuca[Noun]
oblique	oblicuo
obliquely	oblicuamente
obliqueness	oblicuidad[Noun]
obliquity	oblicuidad[Noun]
obtain	obtener[Verb]
occident	occidente, poniente, oeste[Noun]
occidental	occidental
occipital	occipital[Noun]
occipitally	occipitalmente[Adverb]
occlude	obstruir[Verb]
ocean	oceano
occult	oculto
occultism	ocultismo
occultist	ocultista
occupation	ocupacio/n
occupant	ocupante
occupants	ocupantes
occupies	ocupa
occupational	ocupacional
occupationally	ocupacionalmente
occupations	ocupaciones
occupied	ocupado[Adjective]
occupying	ocupando[Verb]
occupy	ocupar[Verb]
occur	ocurre
occurred	ocurrio/,ocurrido[Verb]
occurrence	ocurrencia
occurs	ocurre
occurrences	ocurrencias
occurrent	ocurrente
of course	claro
oceanfront	costa
of	de
odorless	inoloro
oceangoing	maritimo
oceanic	oceanico
oceanographer	oceanografo
oceanographic	oceanografico[Adjective]
oceanographers	oceanografos
oceanographical	oceanografico[Adjective]
oceanographically	oceanograficamente[Adverb]
oceanography	oceanografia
oceanologist	oceanografo
oceanologic	oceanologico
oceanological	oceanologico
oceanologically	oceanologicamente
oceanology	oceanologia
oceans	oceanos
octagon	octa/gono
octagonal	octagonal
octahedra	octaedro
octagonally	octagonalmente
octagons	octagonos
october	octubre
odometer	odometro
odometers	odometros
odontologst	odontologo
odontology	odontologia
odor	olor
oeuvre	obra
odorous	oloroso
odors	olores
oeuvres	obras
oil	el aceite
office	la oficina
offer	ofrecer
ohm	ohm
ohms	ohms
oiler	aceitera
olives	aceitunas
olive	la aceituna
older	mayor
old	viejo
oligarch	oligarca
oligarchic	oligarquico
oligarchical	oligarquico
oligarchy	oligarquia
omen	ag�ero
omelette	la tortilla
omens	ag�eros
onion	cebolla
omit	omitir
omnipotence	omnipotencia
omnipotent	omnipotente
omnipresent	omnipresente
omniscience	omnisciencia
omnivorous	omnivoro
one	uno
onions	cebollas
onion	la cebolla
opel	elop
only	solamente
racehorse	 el caballo de carrera[Noun]
qualified	(certified) acreditado[Adjective]
pope	El Papa[Noun]
plates	La/minas[Noun]
outside	afuera
orchestra	la orquesta
or	o
open	open
ordinary	ordinario
other	otro
pal	amigo[Noun]
pacify	apaciguar[Verb]
owe	deber
overcoat	el abrigo
oven	el horno
oven	orno
overload	sobrecargar[Verb]
overloaded	sobrecargado[Adverb]
overprice	sobreprecio[Noun]
overpopulated	superpoblado[Adjective]
overpriced	sobrevalorado[Adjective]
overview	visio/n general[Noun]
pacemaker	marcapasos[Noun]
pace	paso[Noun]
pacifistically	paci/ficamente[Adverb]
pacific	pac�fico[Adjective]
pacific	pacifico[Adjective]
pachyderm	paquidermo[Adjective]
pachydermal	paquide/rmico[Noun]
pacification	pacificaci�n
pacifically	pac�ficamente[Adverb]
pacifications	pacificaciones
pacifies	pacifica
pacificator	pacificador[Noun]
pacifier	pacificador
pacificators	pacificadores
pacificist	pacifista[Adjective]
pacifism	pacifismo[Noun]
pacifist	pacifista[Noun]
pacifistic	pacifista[Adjective]
painful	doloroso
pain	el dolor
package	el paquete
package	empaquetar[Verb]
pack	paquete[Noun]
packaged	empaquetado[Adjective]
packages	empaques
packager	empaquetador[Noun]
packagers	empaquetadores
packaging	empaquetando
packagings	empaquetados
packed	guardado (that's just 1 meaning)
pager	mensa/fono, buscapersonas
paella	paella[Noun]
packet	paquete
pagan	pagano[Noun]
paganism	paganismo[Noun]
paganization	paganizacion[Noun]
paid	pagado
painfully	dolorosamente[Adverb]
painter	el pintor
painless	indoloro/sin dolor
paint	pintar
painted	pintado[Verb]
painting	la pintura
painters	pintores[Adjective]
pair	par[Adjective]
paints	pinturas[Noun]
pajama	pijama[Noun]
pajamas	piyamas[Noun]
pamper	chinear[Verb]
pale	pa/lido[Adjective]
palace	palacio[Noun]
palaces	palacios[Noun]
palazzo	palacio[Noun]
palaeontology	paleontologÔøΩa[Noun]
palazzi	palacios[Noun]
palazzos	palacios[Noun]
peach	durazno
pea	el guisante
paper	el papel
pamphlet	folleto[Noun]
pancake	panqueque[Noun]
pan	sarte/n[Noun]
pancakes	panqueques[Noun]
park	el parque
passenger	el pasajero
parsley	el perejil
party	la tertulia
pass	pasar
passport	el pasaporte
passengers	pasajeros[Noun]
passively	pasivamente[Adverb]
passiveness	pasividad[Noun]
paw	la garra
pause	la pausa
pause	pausar
paying	pagando
pay	pagar
peace	la paz
peace	paz
peaches	duraznos
pin	el alfiler
pet	el animal dome/stico[Noun]
peanut	el cacahuate
perfume	el perfume
people	la gente
pear	la pera
pearl	la perla
pen	la pluma
pearl	perla
pencil	lapiz
pen	un boligrafo[Noun]
peppermint	la menta
pepper	la pimienta
perfect	perfecto
permission	el permiso
person	la persona
personality	personalidad
personnel	personal[Noun]
personify	personificar[Verb]
perspire	sudar
pig	el chancho[Noun]
pickle	el encurtido
petal	el pe/talo
piano	el piano
photographer	photographer
pie	el pastel
pilot	el piloto
pig	el puerco
pillow	la almohada
pigeon	la paloma
place	el lugar
pineapple	la anana/[Noun]
pineapple	la pin~a[Noun]
pipe	la pipa
pineapples	las anana/s[Noun]
pineapples	las pin~as[Noun]
pines	los pinos[Noun]
piss	mear[Verb]
pistol	pistola
planet	el planeta[Noun]
plains	llanos[Noun]
placebo	placebo
placenta	placenta, tejido vegetal sobre el que se situan los o/vulos o primordios seminales[Noun]
placed	situado
placentation	placentacio/n[Noun]
placentations	placentaciones
plain	plano, llanura[Noun]
plate	el plato
plasmid	pla/smido
planetarium	planetario[Noun]
planetary	planetario[Adjective]
planets	planetas[Noun]
planimeters	plani/metros[Noun]
planimetric	planime/trico[Adjective]
plantation	plantacio/n[Noun]
plantations	plantaciones
plants	plantas[Noun]
plasm	plasma[Noun]
plasma	plasma
plasmatic	plasma/tico
plasmagenic	plasmage/nico
plasmalemma	plasmalema[Noun]
plastic	pla/tico
plasmids	plasmidios
plasmolysis	plasmo/lisis
plasmolytic	plasmoli/tico
plasmolytically	plasmoli/ticamente[Adverb]
plasodesma	plasmodesmo[Noun]
plasticity	plasticidad
plastid	plasto
plastidial	plastidial, relativo a los plastos[Adjective]
plateau	plataforma [Noun]
plateaus	plataformas[Noun]
poise	aplomo
plus	aÔøΩadido
plug	clavija
pleasure	el gusto
play	jugar
platform	plataforma
platforms	plataformas
platina	platina[Noun]
plausible	plausible
playable	pagable
play	tocar
please	por favor
plenty	lleno
plebiscitary	plebiscitario
plebiscite	plebiscito
plenary	plenaria
plenipotent	plenipotente
plenipotentiary	plenipotenciario
plethora	ple/tora
plethoric	pleto/rico
pleura	pleura[Noun]
pleurae	pleuras[Noun]
pleural	pleural[Adjective]
plexus	plexo
plugs	clavijas
pluggable	enchufable
plugged	enchufado
plumber	el plomero
plum	la ciruela
plumbago	plbago, ge/nero de las Plumbagina/aceas[Noun]
plumb	plomo
plumbaginous	plumbagi/neo[Adjective]
plumbeous	plu/mbeo[Adjective]
plumbic	plu/mbico[Adjective]
plumule	plu/mula[Noun]
plumbiferous	plumbi/fero[Adjective]
plumose	plumoso[Adjective]
plumulate	plumulado[Adjective]
plumulose	plumuloso[Adjective]
pluralism	pluralismo
pluralistic	plurali/stico
pluralist	pluralista
pluralistically	plurali/sticamente
plurals	plurales
plurality	pluralidad
pluralization	pluralizacio/n
pluralize	pluralizar
pluralized	pluralizado
pluralizer	pluralizador
pluralizers	pluralizadores
pluriaxial	pluriaxial
pluripotent	pluripotente
pluses	aÔøΩadidos
pocket	el bolsillo
pneumatic	neuma/tico
plutocracy	plutocracia
plutocrat	pluto/crata
plutocratic	plutocra/tico
plutocratically	plutocra/ticamente
pluton	pluto/n
plutonic	pluto/nico
plutonian	plutoniano
plutonium	plutonio
pluvial	pluvial
pneumatically	neuma/ticamente
pneumatics	neuma/tica
pneumaticity	neumaticidad
pneumatology	neumatologi/a
pneumatolysis	neumatolisis
pneumonia	neumoni/a
pneumonic	neumo/nico
poem	el poema[Noun]
pocketbook	libro de bolsillo
pocketbooks	libros de bolsillo
pocketknife	navaja
podium	posio
poet	el poeta
poems	poemas
poesies	poesi/as
poetic	poe/tico
poetical	poe/tica
poetically	poe/ticamente
poinsettia	poinsetia, flor de navidad, ge/nero de las Euforbia/ceas
poignant	punzante[Adjective]
poignancy	viveza
point	punto
pointed	puntiagudo[Adjective]
pointer	puntero
pointillism	puntillismo
pointillist	puntillista
pointillistic	puntillistico
points	puntos
poop	caca[Noun]
pond	el estanque
poisoned	envenenado
poison	veneno
poisonously	envenenadamente
poisoner	envenenador
poisoning	envenenando
poisonous	venenoso
poker	hurgo/n
poisons	venenos
polar	polar
polarimeter	polari/metro
polarimeters	polari/metros
polarities	polaridades
polarity	polaridad
polarizable	polarizable
polarizes	polariza
polarizables	polarizables
polarization	polarizacio/n
polarize	polarizar
polarized	polarizado
polarizer	polarizador
polarizers	polarizadores
polarizing	polarizando
polemic	pole/mica
pole	polo
polemical	pole/mico
polemically	pole/micamente
polemics	pole/micas
polemicist	polemicista
polemist	polemizador
police	polici/a
policewoman	polici/a
policies	poli/ticas
policewomen	polici/as
policy	poli/tica
poliomyelitis	poliomelitis
polis	polis
pool	la piscina[Noun]
pools	las piscinas[Noun]
popcorn	las palomitas[Noun]
poor	pobre
products	PRODUCTOS[Noun]
prearranged	arreglado de antemano[Adjective]
posters	carteles[Noun]
poster	el cartel[Noun]
porch	el porche
popular	popular
possible	posible
postman	cartero(a)[Noun]
powder	el polvo
pound	la libra
potato	la papa
potato	la patata
pray	orar
practice	practicar
prayer	oracio/n[Noun]
pray	rogar[Verb]
prayers	oraciones[Noun]
prayer	ruego[Noun]
preamble	prea/mbulo[Noun]
preach	predicar[Verb]
prayers	ruegos[Noun]
preacher	predicador[Noun]
preach	sermonear[Verb]
preaches	predica[Verb]
preachers	predicadores[Noun]
preaching	predicacio/n[Noun]
preaching	sermo/n[Noun]
preambles	prea/mbulos[Noun]
pretty	bonito
president	el presidente
pregnant	embarasada (really)
precious	preciosa[Adjective]
precise	preciso
predict	predecir
prefer	preferir
prepare	preparar
price	el precio
pretty	lindo
prevent	prevenir
prize	el premio
private	privado/privada
principal	spainsh
problem	el problema
pupil	a alumno[Noun]
punish	castigar
puddle	charco
program	el programa
prostitute	lklklkj[Conjunction]
prostate	pro/stata[Noun]
promise	prometer
pronounce	pronunciar
proud	orgulloso
prostitute	prostituta[Noun]
protect	proteger
prove	probar
puddles	charcos
pumpkin	la calabaza
quail	acobardarse[Verb]
quaff	beber a grandes tragos[Verb]
puss	cara
purse	la bolsa
purchase	la compra
purple	morado
pure	puro
quackery	charlataneri/a
qua	en funciones de, en su condiciÔøΩn de[Preposition]
pussy	micha
pussycat	minino
put	poner
q	q
quack	graznido
quack	matasanos[Noun]
quadruple	cua/druple[Noun]
quadrangular	cuadrangular[Adjective]
quadrangle	cuadrÔøΩngulo [Noun]
quadrangles	cuadrÔøΩngulos[Noun]
quadraphonic	cuadrafÔøΩnico[Adjective]
quadrant	cuadrante
quadrants	cuadrantes[Noun]
quadraphony	cuadrafonÔøΩa[Noun]
quadrature	cuadratura
quadratic	cuadrÔøΩtico
quadratically	cuadrÔøΩticamente[Adjective]
quadriceps	cuadriceps
quadriplegic	cuadriple/gico
quadrillion	cuatrillÔøΩn[Noun]
quadripartite	cuatripartita[Adjective]
quadripartitely	cuatripartitamente[Adjective]
quadruped	cuadru/pedo[Noun]
quadroon	cuartero/n[Noun]
quadriplegic	paralÔøΩtico[Adjective]
quadruplet	cua/druplo[Noun]
quagmire	pantano[Noun]
quagmires	pantanos[Noun]
quaintness	cara/cter pintoresco[Noun]
quail	codorniz[Noun]
quaint	pintoresco[Adjective]
quake	temblor[Noun]
quake	temblar[Verb]
race	(ethnicity, etc.) la raza [Noun]
race	carrera[Noun]
qualified	condicional, limitado, con salvedades[Adjective]
rabbits	conejos[Noun]
rabbit	el conejo
quality	la calidad
quantity	la cantidad
question	la pregunta
queen	la reina
r	net(la red)[Noun]
quick	pronto
quiet	quieto
quickly	rapidamente[Adverb]
rabbi	rabino[Noun]
raccoons	mapache[Noun]
rabies	rabia[Noun]
rabid	rabioso[Adjective]
rabidly	rabiosamente[Adjective]
raced	e/l competio/[Verb]
racecourse	pista de carreras[Noun]
upgrade	 mejoramiento
ruinate	"destruir; ruinar[Noun]"
ruin	"ruina; bancarrota"
rank	(level) nivel[Noun]
rail	(railroad) vi/a[Noun]
rail	barandilla, pasamanos[Noun]
radiance	brillantez (f), resplandor (m)[Noun]
racehorses	caballos de carreras[Noun]
racehorse	carrera de caballos[Noun]
races	carreras[Noun]
racing	carreras[Noun]
racetrack	hipo/dromo[Noun]
racial	racial[Adjective]
racism	racismo[Noun]
racist	racista[Adjective]
racists	racista[Noun]
radar	radar[Noun]
racket	raqueta (for tennis)[Noun]
rack	rejilla[Noun]
racquet	raqueta[Noun]
radars	radares[Noun]
radiant	brillante, resplandeciente[Adjective]
radians	radianes[Noun]
radiantly	brillantemente
ragged	desigual, mellado[Adjective]
radio	la radio
radiation	radiacio/n (f)[Noun]
radiate	radiar, irradiar (heat) [Verb]
radical	radical[Adjective]
radically	radicalmente[Adverb]
radii	radios (pl. of radius=radio)[Noun]
radish	rabano
radioactive	radioactivo[Adjective]
radioactively	radioactivamente[Adverb]
radiometrically	radimÔøΩtricamente[Adverb]
radioastronomy	radioastronÔøΩmico[Noun]
radioautograph	radioautografo[Noun]
radioautographic	radioautogrÔøΩfico[Noun]
radioautography	radioautografÔøΩa[Noun]
radiobiologic	radiobiologico[Noun]
radiobiologically	radiobiologicamente[Adverb]
radiobiology	radiobiologia[Noun]
radiochemist	radioquÔøΩmico[Noun]
radiobroadcast	transmisiÔøΩn de radio[Noun]
radiobroadcaster	transmitidor de radio[Noun]
radiochemistry	radioquÔøΩmica[Noun]
radiochlorine	radioclorina[Noun]
radiography	radiografi/a[Noun]
radiology	radiologi/a[Noun]
radiolysis	radiolosis[Noun]
radiolytic	radiolÔøΩtico[Adjective]
radiometeorograph	radiometeografo[Noun]
radiometer	radiometro[Noun]
radiometers	radiometros[Noun]
radiometric	radiomÔøΩtrico[Adjective]
radiometry	radiometrÔøΩa[Noun]
radios	radios[Noun]
radioscopic	radioscÔøΩpico[Adjective]
radioscopy	radioscopÔøΩa[Noun]
radiosensitive	radiosensitivo[Adjective]
radiosensitivity	radiosensitividad[Noun]
radiotherapy	radioterapia[Noun]
radishes	rabanos
rage	rabia, furor[Noun]
radius	radio[Noun]
raffle	rifa, sorteo[Noun]
rag	trapo (piece of cloth)[Noun]
rafter	viga[Noun]
raid	incursio/n[Noun]
rags	los trapos[Noun]
ragman	trapero[Noun]
raids	incursiones[Noun]
railing	barandilla[Noun]
rainsquall	chubascos[Noun]
railroad	el ferrocarril
raincoat	el impermeable
rain	la lluvia
rain	llover
rainbows	los arcoirises[Noun]
raindrop	la gota de lluvia[Noun]
raincoats	los impermeables[Noun]
rainfall	la lluvia[Noun]
raindrops	las gotas de lluvia[Noun]
rained	llovio/[Verb]
rains	las lluvias[Noun]
raining	lloviendo[Verb]
ran	corrio/[Verb]
rainstorm	el tormento de lluvia[Noun]
raisin	la pasa
raisin	la pasa de uva[Noun]
rainy	lluvioso[Adjective]
raise	rcriar[Verb]
raise	subir[Verb]
raisins	las pasas, las pasas de uva[Noun]
rancor	el rancor[Noun]
ranch	la finca[Noun]
rang	sono/[Verb]
rather	(than) en vez de[Conjunction]
raptor	el raptor[Noun]
rapid	ra/pido, ra/pida[Adjective]
rap	tocar, golpear[Noun]
rape	violar[Verb]
raped	violo/[Verb]
rapidly	rapidamente[Adjective]
raspberry	la frambuesa
rare	raro
rat	la rata[Noun]
readjust	ajustar de nuevo[Verb]
reach	alcanzar[Verb]
raw	crudo
rations	las raciones[Noun]
rather	mejor que
ration	racio/n
ray	irradiar[Verb]
razor	la navaja
rayon	rayÛn[Noun]
reabsorb	reabsorber[Verb]
reabsorption	reabsorciÛn[Noun]
read	estudiar[Verb]
reading	indicacio/n[Noun]
read	leer
reader	lector[Noun]
readers	lectores[Noun]
reader	libro de lectura[Noun]
readings	indicaciones[Noun]
readings	lecturas[Noun]
reading	leyendo
readjusts	ajusta de nuevo[Verb]
readjustment	nuevo arreglo[Noun]
readjustment	reajuste[Noun]
rice	arroz
reply	contestar
realize	darse cuenta de[Verb]
reads	estudia[Verb]
reads	lee[Verb]
readjusts	reajusta[Verb]
ready	listo
ready	propenso[Adjective]
real	real
realism	realismo[Noun]
real	verdadero[Adjective]
realist	realista[Noun]
realistic	realista[Adjective]
realistic	vivo[Adjective]
rent	el alquiler
receipt	el recibo
refrigerator	la nevera
recipe	la receta
receive	recibir
recent	reciente
recycle	reciclar[Verb]
recognize	recognize[Noun]
recommend	recomendar
recognize	reconocer
recommendation	recomendacio/n[Noun]
recommendation	recomendado
recommended	recomendado[Adjective]
reconcile	reconciliar[Verb]
reconciliation	reconciliacio/n
red	rojo
remember	recordar
refuse	rehusar
regular	regular
regret	sentir
relax	relajar
remove	remover
repair	reparar
repeat	repetir
rest	descansar
request	pedir
resentment	resentimiento[Noun]
respect	respetar
restaurant	el restaurante
review	el repaso
result	la resulta
return	regresar[Verb]
return	volver
rib	la costilla
right	derecha
rice	el arroz
ride	montar[Verb]
rich	rico
ring	el anillo
rim	llanta
right	verdad[Adjective]
rime	rima
riming	rimando
road	el camino
ripe	maduro
ringing	sonando
risk	riesgo[Noun]
rise	subir
room	el cuarto
roof	el techo
roller	rodillo
rollers	rodillos
romantic	romantico[Adjective]
rooster	el gallo
room	sala
rooms	salas
routing	enrutamiento
rope	la cuerda
rose	la rosa
rotten	podrido
round	redondo
rub	frotar
rubber	la goma
rude	rudo
rug	tapete
rugs	tapetes
season	"estaci\'on del a\~no (noun); condimentar (verb)"
rulings	"fallos; decisiones de...[Noun]"
ruined	"ruinado; bancarrotado[Verb]"
ruination	ruinacion[Noun]
ruinations	ruinaciones[Noun]
rulers	gobernantes[Noun]
rule	la regla
ruins	ruinas[Noun]
ruler	la regla
ruled	reglado[Verb]
rules	reglas[Noun]
ruling	reglando[Verb]
seal	"foca; sello"
rumble	"retumbar;hacer estruendo; ruido sordo;asiento trasero de un cupe[Noun]"
rum	el ron
rumba	rumba[Noun]
save	ahorrar
saffron	azafran[Noun]
run	correr
rumor	el rumor
rumbled	retumbado
sacrifices	dewayne
rust	el moho
sacrificer	quien realiza sacrificios[Noun]
rut	rut
sabbat	sa/bado[Noun]
sabbath	sa/bado[Noun]
sabbatic	saba/tico[Adjective]
sabbatical	saba/tico[Adjective]
sabotage	sabotaje[Noun]
sabotaged	saboteado[Verb]
sabotages	sabotajes[Noun]
sabotaging	saboteando[Verb]
saboteur	saboteador[Noun]
saccharin	sacarina[Noun]
saccharose	sacarosa[Noun]
sacerdotal	sacerdotal[Adjective]
sack	saco[Noun]
sacraments	sacramentos
sacred	sagrado[Noun]
sacrifice	sacrificar
sacrificed	sacrificado
sacrifice	sacrificio[Noun]
sadden	entristecer[Verb]
sacrilege	sacrilegio[Noun]
sacrilegious	sacrilego[Adjective]
sacristan	sacristan[Noun]
sad	triste
saddle	montura[Noun]
sadist	sa/dico[Adjective]
sadist	sadista[Noun]
saddle	silla de montar [Noun]
sadomasochism	sadomasoquismo[Noun]
sadly	tristemente[Adverb]
sadness	tristeza[Noun]
sadomasochist	sadomasoquista
sadomasochist	sadomasoquista[Adjective]
sadomasochistic	sadomasoquista[Noun]
safari	safari
safe	salvo
safety	seguridad[Noun]
sausage	chorizo[Noun]
sausage	salchicha[Noun]
saliva	saliva
saint	san[Noun]
saint	santo[Noun]
sail	vela[Noun]
saints	santos[Noun]
sale	venta[Noun]
salsa	salsa[Noun]
salutations	saludos[Noun]
salute	saludar
salvation	salvacio/n
sarcasm	sarcasmo[Noun]
salve	ungu.ento[Noun]
sarcastic	sarcastico[Adjective]
satisfied	satisfecho
seabird	ave marina
scuba diving	buceo
scream	chillar
say	decir
say	decir, digo
saying	dicho
sayings	dichos
schedule	el horario
scale	escala
scarlet	escarlata
scarf	la bufanda
scar	la cicatriz
science	la ciencia
school	la escuela
scrambled	revuelto
screwdriver	el destornillador
screen	pantalla
screw	tornillo[Noun]
screws	tornillos[Noun]
sea	el mar
sculpture	la escultura
seabed	lecho marino
seacoast	costa del mar
seacoasts	costas del mar
seafloor	fondo del mar
seagull	gaviota
seafood	mariscos
seagulls	gaviotas
seahorse	hipocampo, caballo de mar
seals	"focas; sellos"
sealant	sellador
sealed	sellado
search	busqueda (noun)
seam	costura
sealskin	piel de foca
seaquake	maremoto
seaman	marinero
seamen	marineros
seamstress	modista
seaports	puerto de mar
seashell	concha marina
seas	mares
seashells	conchas marinas
seashore	costa del mar
seashores	costas del mar
seasick	mareado
seaside	playa, costa
soccer	"f&uacute;tbol"
sidewalk	acera, banqueta
shave	afeitar
seize	agarrar[Verb]
seesaw	balanci/n
seek	buscar
seat	el asiento
seasonal	estacional
seasoned	sazonado
second	el segundo
seated	sentado
secret	el secreto
secretary	la secretaria
seed	la semilla
secure	seguro[Adjective]
see	ver
seem	parecer
sharp	agudo
sew	coser
select	escoger[Verb]
seldom	raramente[Adverb]
sentence	la frase
send	mandar
sell	vender
sensible	razonable
sensibly	razonablemente
september	septiembre
serious	serio
serve	servir
seventy	setenta
seven	siete
several	varios
sex	el sexo[Noun]
shape	la forma
sexless	sin sexo[Adjective]
sex	tener sexo[Verb]
shine	brillar
shelf	el estante
she	ella
sheep	la oveja
shrimp	camarone[Noun]
short	corto
ship	el vapor
shoe	el zapato
shirt	la camisa
ship	nave, barco(a)[Noun]
shit	mierda, f. [Noun]
shiver	tiritar
shoes	los zapatos
shoe	zapato
shop	tienda[Noun]
shoulder	el hombro
shout	gritar
shower	la ducha
show	mostrar
shovel	pala[Noun]
shovels	palas[Noun]
shut	cerrar[Verb]
shrink	encoger
side	el lado
sick	enfermo
snug	acogedor[Adjective]
snacks	aperitivos, tentempie¥, refrigerio[Noun]
small	bajo[Adjective]
small	chiquito[Adjective]
sister	cuÒada
since	despue/s de[Preposition]
sign	el letrero
sidewalk	la acera
silence	el silencio
sign	firmar
silver	la plata
silk	la seda
silly	tonto
similar	semejante
simple	sencillo
singer	el cantor
sinful	pecaminoso[Adjective]
sincere	sincero[Adjective]
sincerely	sinceramente
sincerity	sinceridad[Noun]
sinecure	sinecura[Noun]
sinew	tendo/n[Noun]
singsong	mono/tono
singlehanded	sin ayuda[Adjective]
single	solo[Adjective]
sleep	dormir
sky	el cielo
ski	esquiar
sister	la hermana
skate	patinar
six	seis
sit	sentarse
sixty	sesenta
skinny	flaco
skin	la piel
skirt	la falda
sled	el trineo
sleeping	durmiendo
sleeve	la manga
slowly	lentamente
slow	lento
slice	rebanar
slower	mas despacio[Adverb]
smoke	el humo
smoke	fumar
smash	golpear[Verb]
smart	majo[Adjective]
smaller	menor[Adjective]
small	pequen~o[Adjective]
small	small
smallest	menor[Adjective]
smile	la sonrisa
smell	oler
smooth	liso
snack	tomar un aperitivo, picar[Verb]
sneeze	estornudar
snag	un problema, un inconveniente[Noun]
snow	la nieve
snow	nevar
snorkelear	to snorkel
so	de modo que, asi¥ que[Conjunction]
soaked	empapado[Adjective]
specs	"las gafas (de ""spectacles"")[Noun]"
spark	Chisme
spareribs	Costillas
sometimes	a veces
something	algo
somebody	alguien
soft	blando
sofa	el sofa/[Noun]
society	sociedad[Noun]
soldier	el soldado
software	programa
softwares	programas
someone	alguien[Pronoun]
sour	agrio
soul	alma[Noun]
sore	dolorido
son	el hijo
soon	pronto[Adverb]
sorry	siento
soulful	conmovedor[Adjective]
soup	la sopa
south	el sur
special	especial
speak	hablar
speakeasy	un bar prohibido (se usaba en los EEUU cuando fue prohibido el vender o beber el alcohol)[Noun]
stubbly	"lleno de rastrojo, erizado; cerdoso[Adjective]"
stock	acciones[Noun]
steel	acero
stature	altura
spider	arana[Noun]
speech	discurso[Noun]
spectacles	gafas[Noun]
spectacled	que lleva gafas[Adjective]
spell	el hechizo, el encanto[Noun]
speed	la velocidad
speechless	sin habla[Adjective]
sphere	esfero[Noun]
spend	gastar
spells	los hechizos
spheres	esferos[Noun]
squid	calamar[Noun]
square	cuadrado[Noun]
square	plaza[Noun]
spring	saltar[Verb]
sprinter	velocista[Noun]
stamp	el sello[Noun]
staircase	la escalera[Noun]
stain	la mancha
stairway	la escalera
station	estacio/n
star	la estrella
statistics	estadi/stica
stationery	papel
statue	estatua
statues	estatuas
statue	la estatua
stealth	don't know
steak	el biftec
stay	quedar
steal	grab
steaks	items
steaks	things
stealer	grabber
steal	robar
steal	take
stealing	grabbing
stealer	taker
steals	grabs
steals	takes
steam	el vapor
stealth	not sure
steelmaker	acerero, fabricante de acero
steel	el acero
steelwork	aceri/a, fabricacio/n de acero
steels	aceros
steelworker	acerero, trabajador del acero
stereo	estereo[Adjective]
stepwise	progresivo[Adjective]
stereochemical	estereoquimico[Adjective]
stereochemist	estereoquimico[Adjective]
stereochemistry	estereoquimica[Noun]
stereoisomer	estereoisomero[Noun]
stereochemists	estereoquimicos[Noun]
stereoisomeric	estereoisomerico[Adjective]
stereophonic	estereofonico[Adjective]
stereophonically	estereofonicamente[Adverb]
stereophony	estereofonia[Noun]
stereophotographic	estereofotografico[Adjective]
stereophotography	estereofotografia[Noun]
stereotropism	estereotropismo[Adjective]
stereotype	esterotipo[Noun]
store	almacenar[Verb]
stop	dejar de (to stop doing something)[Verb]
stop	detenerse[Verb]
stomach	el esto/mago[Noun]
stocking	la media
stockings	las medias[Noun]
stone	la piedra
stoplight	la sema/fora[Noun]
stop	pararse
stroll	andar[Verb]
straight	derecho[Adjective]
story	el cuento
store	la tienda
storm	la tormenta
storybook	el libro de cuentos[Noun]
stove	la estufa
stranded	desamparado[Adjective]
straighten	enderezarse [intransitive][Verb]
stress	el estrÈs, la presiÛn[Noun]
strategic	estratÈgico[Adjective]
strange	extraÒo[Adjective]
strangely	extraÒamente
strange	raro[Adjective]
stranger	extraÒo[Noun]
stranger	forastero[Noun]
strategy	estrategia[Noun]
street	la calle
strawberry	la fresa
straw	la paja
street corner	la esquina
streets	las calles
strike	golpear[Verb]
strike	huelga[Noun]
strikebreaker	rompahuelgas[Noun]
stubbed	desarraigar[Verb]
strong	fuerte
strongly	fuertemente
stub	trozo, fragmento[Noun]
stubbing	desarraigar[Verb]
stubble	rastrojo[Noun]
thanksgiving	Accio/n de Gracias
target_language	Spanish
target_language	Spanish[]
tackily	abandonado[Adjective]
student	alumno
stubby	lleno de tocones[Adjective]
stubbornness	obstinaciÛn[Noun]
stubborn	terco
stubs	trozos, fragmentos[Noun]
students	alumnos
student	el estudiante
student	estudiante
subject	asignatura[Noun]
studying	estudiando
study	estudiar
students	estudiates
stupidly	est˙pidez, torpeza, necedad[Adverb]
stupid	menso, bobo, est˙pido, torpe, necio[Adjective]
suck	chupas
success	desarrollo[Noun]
suburbs	las afueras[Noun]
successes	desarrollos
successes	exitos[Noun]
swan	cisne
suddenly	de repente
suede	el ante
surgeon	el cirujano
sunday	el domingo
sun	el sol
suit	el traje
suffer	sufrir
suggest	sugerir
summer	el verano
suitcase	la maleta
supper	la cena
sure	seguro
surfboard	tabla de surf[Noun]
swamp	el pantano
surprise	la sorpresa
surprised	sorprendido
tableware	cubiertos, utensilios de mesa
tablespoon	cuchara 
sweet	dulce
tablecloth	la mantel
tablecloth	mantel[Noun]
table	mesa
table	mesa[Noun]
swim	nadar
symptom	si/ntoma[Noun]
symposia	simposio[Noun]
symphonic	sinfo/nico[Adjective]
symphysis	sinfisi/s[Noun]
symphonies	sinfoni/as[Noun]
symphony	sinfoni/a[Noun]
symposiums	simposio[Noun]
synagog	sinagoga[Noun]
symptomatic	sintoma/tico
synagogue	sinagoga[Noun]
synapse	sinapsis[Noun]
synarthrosis	sinartrosis[Noun]
system	sistema[Noun]
tabac	tabaco[Noun]
tab	teddy
tabernacle	taberna/culo
tabernacles	taberna/culos
tablecloths	manteles
tables	mesas
tablespoonful	cucharada
tablespoon	la cuchara grande
tablespoonfuls	cucharadas
tablespoonsful	cucharada
tablespoons	cucharas
tabletop	mesa
tablet	tabletilla
tabletops	mesas
tablets	tabletillas
tabloid	escenario
tabloids	escenarios[Noun]
tabs	orejas, lenguetas, etiquetas[Noun]
taboo	tabu/
taboos	tabu/es
tackier	pegajoso[Adjective]
tacked	sujeto con tachuelas[Noun]
tacit	ta/cito, ta/cita
tabular	tabular
tabulated	tabulado, tabulada
tabularization	tabularizacio/n
tabulate	tabular
tabulator	tabulador, tabuladora
tabulators	tabuladores, tabuladoras
tachometer	taco/metro
tachometers	taco/metros
tachycardia	taquicardia
tachygraphic	taquigr·fico[Adjective]
tachyons	taquio/n
tacitly	ta/citamente
taciturn	taciturno, taciturna
tack	tachuela[Noun]
tall	alto
taffy	caramelo (de az'ucar fundida)[Noun]
taffies	caramelos (de az'ucar fundida)[Noun]
tacking	clavar tachuelas
tactful	con diplomacia
tact	diplomacia
tact	tacto,tino[Noun]
tactfulness	consideraci'on,discreci'on[Noun]
tactfully	discretamente, diplom·ticamente 
taffetized	entafetado[Adjective]
taeniasis	infecci'on con tenia (gusano plano)[Noun]
tad	ni~no,nene[Noun]
tactically	t'acticamente[Adverb]
tactic	ta/ctica
tactical	t·ctico[Adjective]
tactician	t'actico[Noun]
tactics	ta/cticas
tactile	tactil,tangible[Adjective]
tactilely	tactilmente,sensiblemente[Adverb]
tactless	torpe,descortez[Adjective]
tactlessly	torpemente,descortezmente[Adverb]
tactlessness	torpeza,descortec'ia[Noun]
tadpole	renacuajo[Noun]
tadpoles	renacuajos[Noun]
taffeta	tafeta[Noun]
tail	cola
tag	etiqueta,r'otulo[Noun]
tagged	etiquetado[Adjective]
tagalong	sucesi'on,repetici'on[Noun]
tails	colas
tail	el rabio
tailor	sastre ( noun)
tailors	sastres ( noun)
tales	cuentos  ( stories)
takeoff	despegar ( aviation)
take	tomar
taken	tomado
take	tomar ( verb)
talent	talento
talents	talentos
talented	talentoso
talk	hablar
talisman	talisma/n
talkative	hablador ( noun)
talker	hablador
talked	hablo/
talkers	habladores
talking	hablando
tan	bronceado ( as in suntan)
tame	domar ( to tame as in animals)
taller	ma/s alto
talon	talo/n
talons	talones
tamale	tamal
tamarind	tamarindo ( the fruit)
tameable	domable
tame	manso
tamed	domado
tameless	indomable
tanned	bronceado ( as in suntanned )
tangerine	la mandarina
tango	tango ( the dance)
tangos	tangos ( the dance )
tank	tanque
tape	grabar ( as in tape a show)
tape	la cinta
tapioca	tapioca
tarantula	tarantula
tarantulas	tarantulas
tardily	tardemente
tardiness	tardi/a
teen	adolescente
tearjerker	arrancala/grimas
tattletale	chivato ( cuban slang)noun
taster	gustador
taste	gusto
tarnished	manchado ( stained)
tarnish	manchar ( to stain)
tariff	tarifa
tariffs	tarifas
task	quehacer ( chore)
tarts	tartas ( as in little cakes)
taskwork	quehaceres ( chores)
tasks	querhaceres (chores)
tasted	gusto/
tastefulness	gusto
tasteful	gustoso
tasteless	sin gusto, insi/pido
tasters	gustadores
tasting	gustando
tasty	gustoso
tasty	sabroso
teammate	compan~ero de equipo
team	el equipo
team	equipo ( as in football)
tax	impuesto ( as in IRS)
tavern	taberna
tattoo	tatua/je
tattooed	tatuado
tattoos	tatuajes
taut	tenso
taverna	taberna
taverns	tabernas
teacher	maestra,profesora
teacher	maestro, profesor
taxidermy	taqui/dermia
taxicab	taxi
taxis	taxis
tea	te/
teachers	maestros, profesores
teammates	compan~eros de equipo
tear	desgarrar[Verb]
teams	equipos
teapot	la tetera
teapot	tetera
teargas	gas lacrimante[Noun]
teargas	gas lacrimo/geno[Noun]
tear	la/grima[Noun]
teardrop	la/grima[Noun]
teardrop	lagrima
tear	rajar
tear	rasgar[Verb]
tearful	lloroso[Adjective]
tease	burlarse ( to tease ( someone )
tears	desgarra[Verb]
tears	rasga[Verb]
teas	te/s
teasingly	burlonmente
tease	embromar[Verb]
teases	embroma[Verb]
teases	molesta[Verb]
tease	molestar[Verb]
teaspoonful	cucharadita
teaspoon	cucharilla[Noun]
teaspoon	la cucharita
teaspoonfuls	cucharaditas
teaspoonsful	cucharaditas
teaspoons	cucharillas[Noun]
teem	pulular
technic	te/cnico 
teatro	teatro ( theater )
teat	teta[Noun]
teats	tetas[Noun]
technical	te/cnico
technique	te/cnica
technicalities	tecnicalidades
technicality	tecnicalidad
techniques	te/cnicas
technocracy	tecnocracia
technocrat	tecno/crata
technologic	tecnolo/gico
technologically	tecnolo/gicamente
technostructure	tecnoe/structura
technologies	tecnologi/as
technology	tecnologi/a
tedious	tedioso
tediously	tediosamente
teenager	adolescente
teenagers	adolescentes
teens	adolescentes
thank	agradecer
terrifying	aterrante
teller	cajero ( cashier)
tell	contar
teeth	dientes
teeter	tambalear 
telecommunicate	telecomunicar
telecommunication	telecomunicacio/n 
telecommunications	tele/comunicaciones
teleconference	telecomferencia
telephone	tele/fono
teleconferenced	teleconferencio/
teleconferences	teleconferencias
teleconferencing	teleconfiriendo
telecourse	telecurso
telefacsimile	telefacsi/mile
telefilm	telefilm
telegram	telegrama
telegrams	telegramas
telepathic	telepa/tico
telepathy	telepati/a
telephones	tele/fonos
telephoned	telefoneo/
televisions	tele/visiones
telephony	telefoni/a
telephoto	telefoto
telephotographic	telefotogra/ficamente
telephotography	telefotografi/a
teleprinter	teleimpresora
teleprompter	telepro/mpter
telescope	telescopio
telescopes	telescopios
telethon	teleto/n
televiewer	televidente
televise	televisar
television	televisio/n
televisor	televisor, televisio/n
televisors	televisores, televisiones
televisual	televisual
tellers	cajeros (cashiers)
tent	carpa
tend	cuidar
ten	diez
temple	el templo
temper	genio
telly	televisio/n ( TV)
temblor	temblor ( as in earthquake)
temerarious	temerario
temerity	temor
temp	temporario
temperament	genio, temperamento
temperaments	genios, temperamentos
temperamental	temperamental
temperamentally	temperamentalmente
temperature	la temperatura
temperature	temperatura
temperatures	temperaturas
tempered	templado
tempest	tempestad
tempestuous	tempestuosidad
tempt	tentar ( to tempt)
temptation	tentacio/n
temptations	tentaciones
tempted	tento/
tenant	inquilino
tenacious	tenaz
tenaciousness	tenacidad
tenaciously	tenazmente
tenacity	tenacidad
tenants	inquilinos
tens	de/cimos
tennis	el tenis
tennis	te/nis
tendencies	tendencias
tendency	tendencia
tenebrous	tenebroso
tender	tierno
tender	tierno ( as in gentle)
tennist	tenista
tension	tensio/n
tense	tenso 
termite	comeje/n, termitas
tenth	de/cimo
tentacle	tenta/culo 
tentacles	tenta/culos
tenths	decimos
term	te/rmino
tergiversate	tergiversar
tergiversator	tergiversador
tergiversation	tergiversio/n
teriyaki	teriyaki
terrace	la terraza
terms	te/rminos
terrific	magni/fico
terraqueous	terra/queo
terrace	terraza
terrain	terrun~o
terrains	terrun~os
terrarium	terrario
terreplein	terraple/n
terrazzo	terraza (terrazzo,terrace )
terrestrial	terre/stre
terrible	terrible
terribly	terriblemente
terrified	terrorizado
terrifies	terroriza
terrify	terroriza
terrorized	aterrado
terrorize	aterrar
terrifying	espeleznante
territories	territorios
territory	territorio
terror	terror
terrorism	terrorismo
terrorist	terrorista
terrorists	terroristas
terrorizes	aterrar
terrorizers	terroristas
testified	atestigua/do
testa	cabeza ( head)
test	el examen
test	exa/men
terrors	terrores
testicles	companeros
testicles	testi/culos
testicular	testicular
testify	atestiguar
testified	testi/fico
testimonialize	dar testimonio
testify	testificar
testimonial	testimonio
textbook	el texto
textbook	libro de texto, manual
testing	proba/ndo[Verb]
testimonials	testimonios
testimonializer	uno que da testimo/nio
testimonies	testimonios
testimony	testimonio
testings	prue/bas
tetanus	te/tano
testis	testi/culo
testosterone	testo/sterona
testudo	testudo(one with a  big head)
tetanic	teta/nico(a)
tetanically	teta/nicamente[Adverb]
tetanization	tetanizacio/n
tetanizing	tetanizacio/n
tetracycline	tetraci/clina
tetrafluoride	tetrafluo/ruro
text	texto
textbooks	manuales
thanked	agradecio/
thank	dar gracias
thankful	agradecido
thankfully	agradecidamente
thankfulness	agradecimiento
thanks	gracias
thankless	malagradecido
thanklessly	malagradecidamnete
thanklessness	malagradecimiento
therein	Adjunto
there	alli/
thence	de alli/[Adverb]
thaw	descongelar ( to thaw)
that	esa[Adjective]
that	eso
thawed	descongelado 
theft	el robo
theater	el teatro
theater	teatro
theaters	teatros
them	ellos
theft	hurto
thefts	hurtos
their	su 
theirs	sus
theism	tei/smo
theist	tei/sta
themselves	ellos mismos
thematic	tema/tica
theme	tema
thematically	tema/ticamente
themes	temas
then	entonces
thenceforth	de alli/ en adelante[Adverb]
thenceforth	desde entonces[Adverb]
theocracy	teocracia[Noun]
theocratic	teocra/tico[Adjective]
theologian	teo/logo
theologians	teo/logos
theoretical	teo/rico[Adjective]
theologic	teolo/gico
theologically	teolo/gicamente
theological	teolo/gico[Adjective]
theology	teologi/a
theorem	teorema
theorems	teoremas
theorist	teo/rico
theories	teorias[Noun]
theorists	teo/ricos
theory	teori/a
theorize	teorizar[Verb]
therapeutic	terapeu/tico
therapeutist	terapeu/ta
therapies	tera/pias
therapy	tera/pia
therapist	terape/uta
therapists	terapeutas
thereat	alla/
thereabout	alrededor
there'd	habri/a
there'll	habra/
thereafter	despue/s
thereabouts	en los alrededores
therefor	entonces
therefore	por eso
united States	Estados Unidos
tycoon	Magnate[Noun]
timothy	Timoteo
threat	amenaza 
those	aquellos
thespian	artista 
these	e/stos
thesaurus	tesauro
thespians	artistas
thingamajig	cachivache
thimble	dedal ( sewing)
thigh	el muslo
thigh	muslo
thighs	muslos
thimbles	dedales (sewing)
thin	delgado
thin	delgado ( person)
thing	la cosa
thingamajigs	cachivaches
things	cosas
this	e/sto
thirst	la sed
think	pensar
thinker	pensador
think	pensar ( to think)
thinkers	pensadores
thinking	pensando
thinks	piensa
third	tercero
thirdhand	terceramano
thirdly	tercera
thirds	tercios
thirties	los trenta
thirst	sed
thirsty	sediento
thirteen	trece
thirtieth	trige/simo
thirty	treinta
thirty	trenta
thorns	espinas
this	esta
thorny	espinoso
thoughtfully	atentamente
thoughtful	atento
though	aunque
thought	pensamiento 
thread	el hilo
thread	hilo
thousand	mil
thoughts	pensamientos
thousandfold	mil veces
thousands	miles
threaded	hilvanar
threads	hilos
threatens	amenaza
threaten	amenazar
threatener	amenazador
threatened	amenazo/
threateningly	amenazadamente
threatening	amenazando
threats	amenazas
tight	apretado
tie	atar
thru	atra/vez
throat	garganta
threw	tiro/
three	tres
threefold	tres veces
threesome	tri/o
throats	gargantas
throat	la garganta
throw	tirar
ticklish	cosquilloso
ticket	el billete
thursday	el jueves
thumb	el pulgar
thugs	malandros
thunder	el trueno
thumbtack	la chinche
thunderstorm	la tronada
thunderbolt	rel/ampago
thunder	trueno
thunderbolts	rela/mpagos
tiara	tiara
thyroid	tiroide
thyroids	tiroides
tic	tic 
tickle	hacer cosquillas
ticket	tique/ ( theater)
tickets	tique/s ( theater)
tide	marea ( as in weather )
tides	mareas ( as in weather)
ties	corbatas ( as in dress tie )
tiger	el tigre
tiger	tigre
tigers	tigres
tightly	apretadamente
tighten	apretar
time	el tiempo
time	hora
tile	loza
tightwad	tacan~o
tightwads	tacan~os
tigress	tigresa
tilde	tilde
tiles	lozas
tile	mosaico
timid	ti/mido
timidly	ti/midamente
timidity	timidez
timidness	timidez
trained	adiestrado ( military)
tonsil	ami/gdalas
toad	batracio ( Animal)
tired	cansado
tiptoe	de puntillas
tingle	erizar (to tingle)
tin	lata
timpani	ti/mpano
tingles	erizos
tins	latas
tinkle	orinar ( to urinate)
tinware	lateri/a
tint	ten~ir ( to tint)
tinted	ten~ido
tints	tintes
tiny	pequen~o
tip	propina ( gratuity) consejo ( advice)
tips	propinas ( gratuities ) consejos ( advice)
tire	la llanta
tire	llanta(car tire)cansar(to tire)
tiredly	cansadamente
tiredness	cansancio
tiresome	canso/n
tirelessly	descansadamente
tireless	sin cansancio
tirelessness	descansancio
tires	llantas ( car tires)
tithe	diezmar
tissue	tejido
tisane	tisana
tit	teta ( as in breast,slang)
titans	titanes
tithes	diezmos
to	my love
to	para
tits	tetas ( as in breasts ,slang)
title	ti/tulo
titles	ti/tulos
tittie	tetica ( as in titties, slang)
titular	titular
toads	batracios
toast	bri/ndis ( wine) or tostar ( as bread)
toasted	brindo/ ( wine) or tosto/ ( bread)
toast	la tostada
toasts	brindi/s(wine) or tostadas(bread)
toaster	el tostador
tolerantly	con tolerancia
toe	dedo del pie
today	hoy
tobacco	tabaco
tobacconist	tabaconero
toilet	escusado
toilet	inodoro
together	juntos
toil	laborar ( as in to work)
toiled	laboro
toilets	inodoros
toilet	retrate
toilsomely	laboriosamente
token	peaje
tolerability	tolerancia
tolerance	tolerancia
tolerant	tolerante
tonight	e/sta noche
tongue	la lengua
tongue	lengua
tome	libro ( book)
tomboy	marimacha
tolerates	tolera
tolerate	tolerar
tolerated	tolero/
tolerating	tolerando
tomato	tomate
tomatoes	tomates
tomb	tumba
tombstone	tumba
tombs	tumbas
tombstones	tumbas
tomes	libros
tomorrow	man~ana
tomorrows	man~anas
ton	tonelada
tonalities	tonalidades
tonality	tonalidad
tone	tono
tones	tonos
tongues	lenguas
tongueless	sin lengua
tons	toneladas
torch	antorcha
toolbox	caja de herramientas
too	demasiado
tool	herramienta
too	tambie/n
took	tomo/
toolboxes	cajas de herramientas
toothbrush	cepillo de dientes
tooth	diente
tools	herramientas
toot	pitar
tooted	pito/
toothache	dolor de muelas
tooth	el diente
toothaches	dolores de muela
toothbrushes	cepillos de diente
top	cima
toothsome	dentudo
toothpick	modadiente 
toothpaste	pasta de dientes
toothless	sin dientes
toothpicks	modadientes
topcoat	sobreabrigo
topaz	topacio
topcoats	sobreabrigos
topic	tema
topiary	topiario
topics	temas
topographer	topo/grafo
topographic	topogra/fico
topographically	topogra/ficamente
topography	topografi/a
torches	antorchas
tormented	atormentado
toreador	torero, toreador
torero	torero, toreador
torment	tormento
tormenter	atormentador
tormenters	atormentadores
tormentor	atormentador
tormenting	atormentando
torturer	atormentador
tortoise	jicotea
torn	roto
torments	tormentos
torrid	to/rrido
tornado	tornado
tornadoes	tornados
tornados	tornados
torpid	torpe
torpedo	torpedo
torpedoes	torpedos
torpedos	torpedos
torpidly	torpemente
torpidity	torpidez
torrent	torrente
torrential	torrencioso
torrentially	torrencialmente
torrents	torrentes
torsion	torsio/n
torso	torso
torsos	torsos
torte	torta ( pie)
torticollis	torti/culis
tortilla	tortilla ( omelet )
tortoises	jicoteas
torture	tortura
tortured	torturado
tournament	campeonato
tourist	guiri[Noun]
toupee	peluca ( wig)
tote	portar 
total	suma
tortures	torturas
torturing	torturando
totals	sumas
toted	porto/ ( carried )
touchable	tocable
touch	tocar
tourism	turismo
tourists	guiri[Noun]
tourists	turistas
tournaments	campeonatos
trade	comercio, intercambiar ( to trade )
toy	el juguete
toy	juguete
towel	la toalla
towed	remolcado 
town	pueblo
towing	remolcando
towel	toalla
towels	toallas
tower	torre
towers	torres
towns	pueblos
toxic	to/xico
toyed	jugueteo/
toying	jugueteando
toys	juguetes
train	el tren
train	tren ( noun) adiestrar ( military)
trainer	adiestrador ( military)
trainers	adiestradores
training	adiestramiento
tree	arbo/l
treasured	atesorado
trapped	atrapado
traits	caracteri/sticas
training	training center
traitor	traidor
trains	tre/nes
traitorize	traicionar
traitoress	traidora
traitors	traidores
transgression	pecado (sin)transgresio/n
transgress	pecar ( to sin)
tramp	puta ( whore )
tram	tram
trajection	trayectoria
trajectories	trayectorias
trajectory	trayectoria
tramcar	tram
tranquilly	tranquilamente
tranquil	tranquilo
tranquilized	tranquilo
tranquilizer	tranquilizante
tranquilizes	tranquiliza
tranquilizers	tranquilizantes
tranquillity	tranquilidad
tranquilness	tranquilidad
transaction	transaccio/n
transactions	transaccio/nes
transatlantic	transatla/ntico
transcontinental	transcontinental
transcend	trascender
transcendence	trascendencia
transcended	trascendio/
transcendental	trascendental
transcendent	trascendiente
transcendentalism	trascendentalismo
transcendentalist	trascendentalista
transcendentalists	trascendentalistas
transcendentally	trascendentalmente
transcendentalizes	trasciende
transcending	trascendiente
transcends	trasciende
transcribe	transcribir
transcripts	transcripcio/n
transfer	transferencia ( noun)
transferable	transferible
transfers	transferencias ( noun)
transform	transformar
transformation	transformacio/n
transfusion	transfusio/n
transfusions	transfusiones
transgressed	peco/ ( sinned)
transgressions	pecados ( sins )
translucent	reluciente
translatable	traducible
transients	transeu/ntes
transition	transicio/n
transitions	transiciones
translates	traduce
translate	traducir
translated	traducido
translation	traduccio/n
translating	traduciendo
translations	traducciones
translator	traductor
translators	traductores
transliterate	transliterar
transliteration	transliteracio/n
translocate	translocar
transsexual	transexual
transmissibility	transmisibidad
transmissible	transmisible
transmission	transmisio/n
transmittable	transmisible
transmissions	transmisiones
transmits	transmite
transmit	transmitir
transsexualism	transexualismo
transvestite	transvesti 
trapeze	trapecio
trapezist	trapecista
trapezoid	trapezoide
trapezoids	trapezoides
tray	bandeja
trash	basura
traps	trampas
trattoria	parrilla
trauma	trauma
traumas	traumas
traumatize	traumar
traumatic	traumatico
traumatized	traumado
travel	viajar
traveler	viajante
travel	viajar ( to travel )
traveled	viajo/
traveling	viajando
travelers	viajantes
travelings	viajes
travels	viajes
trays	bandejas
treasure	tesoro
treason	traicio/n
treat	golosina ( sweets)
treasurer	tesorero
treasurership	tesoreri/a
treasury	tesoreri/a
treasures	tesoros
treats	golosinas ( sweets )
treaties	pacto ( pact )
treatment	tratamiento
treatments	tratamientos
trees	arboles
truck	camion[Noun]
trip	el viaje
trial	juicio
tremble	temblar
trembled	temblo/
trembly	tembloroso
trembling	tempando
trembles	tiembla
tremendous	tremendo
tremendously	tremendamente
trials	juicios
triangle	tria/ngulo
triangles	tria/ngulos
triangular	triangular
tribe	tribu/
tribes	tribu/s
tribulation	tribulacio/n ( woe )
tribunal	tribunal
tribunals	tribunales
tributary	tributo
tributes	tributos
triceps	triceps
trick	truco
twelve	doce
tuesday	el martes
truth	la verdad
turkey	el pavo
turtle	tortuga
two	dos
twin	gemelo[Noun]
twenty	veinte
ultimately	Ultimadamente[Adverb]
typist	el (la) mecano/grafo(a)[Noun]
typhoon	el tifo/n[Noun]
typewriter	la ma/quina de escribir[Noun]
typewriter	la maquina de escribir[Noun]
typhus	el tifus[Noun]
ugly	feo
tyrannize	tiranizar[Verb]
ulcer	ulcera[Noun]
under	bajo
uncover	descubrir
umbrella	el paraguas
umbrella	paraguas[Noun]
ultimatum	ultimatum[Noun]
uncle	tio
understandability	comprensibilidad[Adjective]
understand	entender
undershirt	la camiseta
underline	subrayar
understandable	comprensible[Adjective]
understanding	comprensio/n[Noun]
unemployed	desempleo[Adjective]
underused	infrautilizado[Adjective]
underutilization	infrautilizacio/n[Noun]
underutilize	infrautilizar[Verb]
underwear	la ropa interior
unhappy	infeliz
up	arriba
untie	desatar
university	la universidad
uno	one
unmarried	soltero
until	hasta
untrans	n
untrans	y[]
whatever	"lo que; que/[Pronoun]"
waves	OLAS[Noun]
walk	andar
wager	apuesta[Noun]
vault	bÛveda, sÛtano, caja fuerte[Noun]
use	el uso
vanilla	la vainilla
use	usar
vacancies	vacantes[Noun]
vacancy	vacante[Noun]
vaccination	vacuna
vagina	vagina[Noun]
vaginal	vaginal[Adjective]
vaginas	vaginas[Noun]
valuable	valioso
vain	vano[Adjective]
vainglory	vanagloria[Noun]
wade	chapotear[Verb]
wack	dar un buen golpe a[Verb]
vest	el chaleco
velvet	el terciopelo
vegetable	la legumbre
veal	la ternera
vaulted	saltado, brincado[Verb]
vegetarian	vegetariano[Noun]
verb	el verbo
very	muy
verb	verbo
verbal	verbal
village	el pueblo
view	la vista
vinegar	el vinagre
vocabulary	el vocabulario
vitamin	la vitamina
visit	visitar
vodka	el vodka
voice	la voz
wad	la borra[Noun]
wacke	roca bas·ltica[Noun]
waddle	nalguear, caminar a pasos pequeÒos[Verb]
wadding	relleno[Noun]
wad	tapÛn o corcho[Noun]
wafer	el barquillo[Noun]
wage	el salario[Noun]
wage	sueldo, salario [Noun]
waist	cintura[Noun]
wager	la apuesta[Noun]
wail	lamentarse[Verb]
wail	lamento[Verb]
wages	pago/paga/sueldo[Noun]
wails	lamento(a)[Verb]
waistband	cinturÛn 
waist	la cintura[Noun]
wake up	despertarse
waiter	el camarero
waiter	el mozo
wait	esperar
wait for	esperar
waited	perdado[Verb]
wasp	avispa[Noun]
warm	caliente[Adjective]
wallet	la cartera
wall	la pared
wall	pared (a dentro)
war	la guerra
walnut	la nuez
want	querir
wanted	querido (m), querida (f)
was	fue 
wash	lavar
washing	lavando[Verb]
washed	lavo[Verb]
wasps	avispas
wastebasket	basurero
wastebaskets	basureros
water	el agua
water	el agua[noun]
watch	el reloj
waterfall	la catarata
wave	ola (de agua)[Noun]
welcome	agradable[Adjective]
welcome	bienvenidos[Adjective]
wedding	boda
way	camino[Noun]
wax	cera
wax	la cera
wed	casarse
weather	clima
weather	el tiempo
way	la via[Noun]
we	nosotros
web	tejido tela telaraÒa enredo red trama
weight	carga[Noun]
weighs	considera[Verb]
weighs	pondera[Verb]
week	semana
weekly	semanal
weights	cargas[Noun]
weight	el peso
weight	la pesa[Noun]
weighty	de mucho peso[Adverb]
weights	pesas[Noun]
weights	pesos[Noun]
weird	extran~o[Adjective]
weird	raro[Adjective]
well	bien[Adverb]
welcome	dar la bienvenida a [Verb]
welcome	grato[Adjective]
weld	soldadura[Noun]
weld	soldar[Verb]
west	el oeste
wet	mojado
what	que[Preposition]
where're	Donde esta?
whenever	cada vez que[Adverb]
when	cuando[Adverb]
wheel	la rueda
where	donde
www	RIM (Red Mundial Interna)
wide	ancho
white	blanco
whiskey	el whiskey
while	mientras
whistle	silbar
whiter	ma/s blanco
why	por que/
whore	puta[Noun]
witch	bruja[Noun]
winner	el ganador
windscreen	el parabrisa (se usa en Australia)[Noun]
wind	el viento
win	ganar
wife	la esposa
wife	marida[Noun]
widow	viuda[Noun]
widower	viudo[Noun]
window	la ventana
windshield	el parabrisa
windshield	el parabrisa (se usa en los EEUU)[Noun]
wine	el vino
wing	la ala
winter	el invierno
winners	los ganadores[Noun]
wintering	pasando el invierno (en algun sitio)[Verb]
wintered	paso/ el invierno[Verb]
wise	sabio
witchcraft	brujeria[Noun]
witch	la bruja[Noun]
with	con
witches	las brujas[Noun]
with me	conmigo
writer	el escritor(a)[Noun]
wolf	el lobo
without	sin
world	el mundo
work	el trabajo
wool	la lana
wood	la madera
woman	la mujer
word	la palabra
workbench	mesa de trabajo[Noun]
work	trabajo
workable	trabajable
workbenches	mesas de trabajo[Noun]
worker	trabajador, laborante
worked	trabajo/
workingman	trabajador
workers	trabajadores[Noun]
working	trabajando
workingmen	trabajadores
workman	trabajador[Noun]
wrap	envolver[Verb]
wounded	herida
wound	la herida
worse	peor
worried	preocupado
worry	preocuparse
write	escribir
wrinkle	la arruga
wrestling	lucha libre[Noun]
writes	escribe[Verb]
writing	escritura[Verb]
written	escrito
yon	ahi/ alli/
yellow	amarillo
yearning	anhelo
yearbook	anuario[Noun]
year	an~o
yawn	bostezar
yard	corral[Noun]
xylophone	xilo/fono[Noun]
xylophones	xilo/fonos[Noun]
yacht	yate
yachts	yates
yarn	hilo[Noun]
yard	yarda[Noun]
yawl	yola[Noun]
yawning	bostezando
yawn	bostezo
yawn	el bostezo
yeah	si
yearly	anualmente
yearn	desear
yell	aullar[Verb]
yell	grito
yeast	levadura
yelled	grito/
yellowing	amarillando
yellowed	amarillo/
yellowish	amarillento
yellowish	amarilloso
yellows	amarillos
yet	au/n
yesterday	ayer
yeomanry	burguesi/a
yelp	gan~ir[Verb]
yells	grita
yeoman	hacendado[Noun]
yen	yen
yes	si,afimacion
yield	producir
yew	tejo
yoke	sojuzgar
yolk	yema de huevo
yonder	ahi/ alla/
yore	antan~o
yowl	aullar
yours	el tuyo
young	joven
you	tu/
you	vosotros(plural/informal)[Pronoun]
youngster	jovencito
younger	menor
your	tus
youth	juventud
yourself	tu/ mismo
yourselves	ustedes mismos
youthfulness	juventud
zany	bufo/n[Noun]
ytterbium	iterbio
yttrium	itrio
yule	pascua de navidad
yucca	yuca
yuppie	yuppie
yuppies	yuppies
zounds	ca/spita
zephyr	ce/firo[Noun]
zenith	ce/nit
zenith	cenit
zealot	defensor
zealot	fana/tico[Noun]
zapping	zapeo[Noun]
zealotry	fanatismo[Noun]
zenithal	cenital[Adjective]
zero	cero
zither	ci/tara[Noun]
zinc	cinc[Noun]
zest	deleite[Noun]
zest	la vivacidad[Noun]
zeroes	los ceros[Noun]
zeros	los ceros[Noun]
zigzag	zigzag
zoologist	el zoo/logo[Noun]
zone	faja[Noun]
zodiac	zodiaco[Noun]
zodiacal	zodiacal
zoology	la zoologi/a[Noun]
zoom	pasar zumbando[Verb]
zucchini	el calabaci/n[Noun]
